text_a	text_b	label
苏有朋要结婚了，但网友觉得他还是和林心如比较合适	好闺蜜结婚给不婚族的秦岚扔花球，倒霉的秦岚掉水里笑哭苏有朋！	unrelated
爆料李小璐要成前妻了贾乃亮模仿王宝强一步到位、快刀斩乱麻！	李小璐要变前妻了？贾乃亮可能效仿王宝强当机立断，快刀斩乱麻！	agreed
为彩礼，母亲把女儿嫁给陌生男子，十年后再见面，母亲湿了眼眶	阿姨，不要彩礼是觉得你家穷，给你台阶下，不要以为我嫁不出去！	unrelated
猪油是个宝，一勺猪油等于十副药，先备起来再说	传承千百的猪油为何变得人人唯恐避之不及？揭开猪油的四大谣言！	unrelated
剖析：香椿，为什么会致癌？	香椿含亚硝酸盐多吃会致癌？测完发现是谣言	disagreed
你听说过“伪狂犬病”吗？真正的狂犬病人不会学狗叫	盘点2018第一季度谣言，小孩感染狂犬病发作学狗叫上榜	unrelated
有钱人买房从不选这几层？开发商不会告诉你的秘密，看完才知多坑	买房别买这几层了，连行内人都被坑了，后会知道太晚	agreed
真假？武安某商场家长因孩子争抢玩具大打出手致一人死亡？	邯郸女子微信发布“老人猥亵女童”谣言被拘留	unrelated
其他文玩都在暴跌！为何南红玛瑙价格持续上涨！	盘点那些无厘头的紫砂壶谣言：豆腐开壶、黄龙山绝矿...	unrelated
「悦读」官方发布！恢复微信聊天记录教程！快点学起来……	手机操作微信恢复聊天记录，视频教程	agreed
每晚睡前洗脸后，阿莫西林配它抹脸，坚持4天皮肤又白又嫩	阿莫西林配白醋洗洗脸，变白原来真这么厉害，赶紧试一试	agreed
玲琅满目的植物油做饭致癌，来告诉你正确的选用窍门	猪油和转基因植物油，哪个会致癌？	unrelated
明察｜大连警方：正侦破特大杀人案，网传行凶视频与本案无关	北京将有雷达无法测量的特大狂风暴雨？气象专家辟谣	unrelated
一个补肾的偏方，只需几毛钱的枸杞告别时间短，一次根除	黄奕前夫喊话马苏，不想被广电局封杀就道歉，马苏这是摊上大事了	unrelated
大蒜加它一起吃，防血栓，延缓衰老，一生不得癌症！	女人皮肤暗黄、不水润不用慌！常吃8款养颜食物，排毒养颜更护肤	unrelated
沙湾有人吃羊肉得了SK6病毒？切！我还SK2呢！	「辟谣」病毒式网络谣言如何消除？	unrelated
林更新的一句话疑似支持鹿晗关晓彤分手，网友：也许他们会结婚呢	哪位明星结婚了？林更新，高圆圆赵又廷都来参加了	unrelated
夏季减肥的你千万别错过这些高效刮油食物哦！	最减肥的几种食物，消脂刮油，减肥族的首选	unrelated
廊坊网传飞机撒药治白蛾 市园林局：假消息！	朋友圈谣传医院将收取26元药事服务费 记者求证系假消息	unrelated
王珂再次破产欠六千万巨款！刘涛又哭了，夫妻一起做节目还债	《极限挑战》今天来温州大学拍摄？别传了，这是谣言！	unrelated
白百合电视剧下架，首次反驳出轨并没错！这样的女星还能理直气壮	大肚腩难看，减肥专家教你一招瘦肚子，做个小瘦子	unrelated
微信又出新功能了以后用微信可以免费上网了	微信新功能，可以免费上网，只需这样设置下微信	agreed
张一山患抑郁症将退出娱乐圈？回应：暂时死不了，拍完戏就休息	曝！张一山身体出现问题 未来可能退出娱乐圈	unrelated
冰淇淋融化的越慢，添加剂就越多吗？	每天都滴2滴风油精在肚脐，一个星期后身体竟发生了奇妙的变化	unrelated
美国公布拷问抓到的外星人的视频，称自己来自未来	美国终于公布了活着的外星人的视频！你被惊到了吗？	unrelated
买房万万别选这几种房子，很多人没听劝，交钱后肠子都悔青了	越来越多人买房不选这3个楼层了，听老师傅一说，后悔我家买早了	unrelated
付笛声、任静夫妻皈依佛门？一曲知心爱人重新回忆他们的爱情！	付笛生夫妇近照，两人皈依佛门不出家，四合院豪宅价值数亿	unrelated
嘲讽农民歌曲，那英公然放言刀郎砸电视！	刀郎终于上春晚了！某英隔空喊话：他要上春晚，我就砸电视	unrelated
茄子嫁接西红柿技术	神奇的嫁接术   茄子嫁接西红柿	agreed
40岁男人肾虚，每天吃点，补充雄激素，年轻20岁！	小便次数多，说明肾不好？这18个谣言临沂人别信啦！	unrelated
外星人疑是地球人祖先，科学家似发现其尸体，构造和人类多处相似	美太空舰队在小行星上捕获的新物种外星人，竟然和人构造大致相同	unrelated
华为手机进货价曝光，看看你买的手机多花了多少钱？	华为回应驻美前员工：无事实依据华为要求员工窃取机密为造谣	unrelated
TFBOYS要解散?王源已成立个人工作室	TFboys单人秀太尴尬被传解散	unrelated
李天一获超快减刑提前6年出狱，梦鸽满面春光	李天一提前6年出狱？北京监狱辟谣：仍在服刑	disagreed
很想儿女双全，想知道怎样才能怀上男孩？如何生儿子的秘诀	为何林志颖一直生儿子，贾静雯一直生女儿，控制生男生女的秘诀	unrelated
一把八角，专治前列腺，七天断根，一辈子不反复	一把八角，专治前列腺，4天断根，一辈子不反复！	agreed
老太好心救下一条白蛇，企料那蛇却咬死了老太的儿子	哑巴老太三救小白蛇，洪水来临时哑巴却开口说话：一命还恩	unrelated
又一主持人癌症复发！脸部变形不得已离开舞台，网友：心疼	又一主持人癌症复发 脸部变形不得已离开舞台 网友让人心疼	agreed
清朝末年广西僵尸袭人事件是真是假？官府亲自出动镇压	探究僵尸袭人的未解之谜	unrelated
内科医生推荐:冬天这样吃，3个月治好15年的老胃病，珍藏	睡前吃一个，48小时杀死幽门螺杆菌，不出一周治好老胃病	unrelated
王者荣耀年底停止运营？天美听了想打人！	18号下午开放系统验证？纯属谣言，苹果已经回应	unrelated
《前半生2》女主不是马伊琍，另换其人？	食物相克，这些抗癌食物不能一起吃	unrelated
有人说空心菜是蔬菜里的“毒中之王”，还能放心吃吗？	每天8杯水、散步最养生…十大常见养生谣言，信了就是害自己	unrelated
“飞机就要起飞，一个男人在机舱口跪下！”	飞机就要起飞，一个男人在机舱口跪下！这一幕让人泪崩	agreed
日本311大地震后7年 福岛玫瑰园如今杂草丛生	辟谣：福岛核电站影响日本留学吗	unrelated
全面取消中考？美术纳入高考？不属实！	教育部辟谣科学美术纳入中高考：未发布过该消息	unrelated
交通违法“清零”行动开始了！	辟谣丨听说交通违法“清零行动”卷土重来？	unrelated
吃了荔枝，就会查出酒驾？交警的实验告诉你这是真的！	开车别吃荔枝 会变成“醉驾”的	agreed
喝酒不醉的技巧竟是这？绝对意想不到的千杯不醉小妙招	喝酒千杯不醉的小妙招，你们学会了吗？	agreed
手机上免费看直播，世界上所有频道都能观看，打开微信就可以	不用再充VIP，教你一招，用微信可免费观看全网VIP视频	unrelated
于文华母亲去世，葬礼上这首歌让于文华痛哭流涕，全村都难过落泪	于文华母亲去世，葬礼上这首歌让于文华痛不欲生，全村都难过落泪	agreed
好尴尬 穿中国风百蝶衣亮相戛纳红毯，被保安驱赶了三次	李玉刚工作室发声明 澄清戛纳电影节红毯“被驱赶”谣言	unrelated
九江市民疑在九九隆超市买到“塑料紫菜”，打汤后嚼不烂难扯断	龙口粉丝是塑料做的吗？鲁中网记者现场实验击破谣言	unrelated
腰突俩把野生艾草轻松搞定，3天去根不复发，腰腿疼也管用	腰间盘突出危害大！一把艾草帮你忙，颈椎病也有效果！	agreed
男人这样吃鸡蛋，金枪不倒半小时，吃三天就见效！	男人吃大蒜强精健身？	unrelated
无核葡萄用避孕药，吃了会绝育？！	棉花肉松是谣言，但有不含肉的假肉松	unrelated
农村人注意了，这30个省农村户口要取消了	农村人注意了，这30个省农村户口要取消，不知道你家乡有吗？	agreed
小米Note系列新机曝光，骁龙835+5.99寸全面屏2.0	诺基亚新旗舰曝光，骁龙835+6GB媲美小米6吗？	unrelated
央视公布17种“巨毒食品”？实为恶意篡改编造和旧闻翻炒	燕窝中含有激素？你被这个谣言骗了吧！	unrelated
农村四项费用全面取消，别不知道白交了	现在在农村这几项费用交了等于白交，国家都取消了	agreed
5月1日起全国公交成失联儿童守护点？真假？	5月1日起，全国公交正式成为中国失联儿童安全守护点！	agreed
一家三口吃“黑美人”西瓜死亡	辟谣联盟“亮剑” 谣言止于智者	unrelated
史上最难找的方子，为了家人留着吧，家家都有需要！	最难找的民间偏方，药到病除！为家人留着吧~	agreed
开塞露可以洗脸美白？学会使用一瓶开塞露，脸就可快速变白	开塞露洗脸新用式，适合各种肤质，几天就变白，脸上光光滑滑	agreed
腰间盘突出的朋友请注意，中医大师研究最新验方，对付腰凸有妙招	颈椎病这次碰到对手了，农村地边的地里艾草，对腰间盘突出有妙招	unrelated
科学家发现：一味中药48小时杀死98%癌细胞 发一次救人无数	一味中药48小时杀死98%癌细胞，几分真几分假？	unrelated
一亿两千万第一次一亿两千万第二次，一亿两千万第三次成交	男子自称云南省公安厅副厅长相亲？警方澄清：系17岁务工少年	unrelated
曹艳两岁女儿在济宁大润发被拐？谣言！	曹艳2岁女儿在大润发附近被拐？这个谣言竟跑遍全国了	unrelated
何洁又被赫子铭算计？净身出户，网友直呼：赫子铭放过何洁吧！	赫子铭不想净身出户，录音遭翻译，暗指何洁脾气大，还曾出轨过！	unrelated
传滴滴收购ofo谈判重启 六月将宣布消息	【摩拜回应与ofo合并传言：不考虑合并，	unrelated
生姜能生发吗？	育儿漫画丨新生宝宝皮肤黄=肝病？这些都是谣言，别信！	unrelated
人体器官的排毒时间表，收藏备用！	辟谣│排毒膏能排毒？太阳得从西边出！	unrelated
曹艳两岁女儿在济宁大润发被拐？谣言！	青岛公安：黄岛“卖小鸟玩具的人拐孩子”系谣言	unrelated
万达正式宣告退出房地产，马云却进入了房屋租赁	王健林宣布万达退出房产！网友：难道房地产要崩盘？	agreed
缺课太多遭留级曝关晓彤明年疑似要和王俊凯成为同学，太尴尬	学霸关晓彤因接戏谈恋爱耽误学习，旷课一年，将留级与王俊凯同班	agreed
扼制糖尿病的“天然法宝” 如今血糖稳定在6以下 还能润肠祛燥	猛料啊！刘嘉玲已怀孕两个月，梁朝伟应该乐开花了吧	unrelated
你家吃的油是地沟油吗？只需一片大蒜即可看出油的好坏，赶紧试试	如何辨别地沟油？只要一颗大蒜，3秒能看出油的好坏！	agreed
微波炉加热食物致癌？营养流失？毁脑子？	本周谣言盘点：微波烹调会将营养素损失殆尽	unrelated
以案说法之 案例二 某地出现四个假和尚入室偷肾	辟谣丨兰州来了四个和尚偷肾？这样的谣言何时休？！	unrelated
娱乐圈十大最爱国的明星：姚明拒绝代言，最后一位霸气又给力	姚明拒代言丰田让我们骄傲，同时表示女儿18岁后自己担当	unrelated
大蒜最新吃法，和它一起泡，连续吃3天，千年人参都不如	它是糖尿病的死对头，每天吃一点，血糖慢慢降下来身体更健康	unrelated
红皮萝卜什么时候种植？这种蔬菜能降血压治痛风	糖尿病患者最应该吃的2类蔬菜，控血糖促排尿降血压，美味常见！	unrelated
2018京东白条秒提现方法 花呗套现最安全	花呗套现方法流程是什么 京东白条最新提现方法	unrelated
激素草莓会致孩子性早熟？听听专家怎么说	大草莓不等于用膨大剂 草莓上市季这些谣言不可信	unrelated
刘强东回应京东入主延边	法国生态部长回应性骚扰传闻：谣言“很伤人”	unrelated
网友爆李亚鹏新女友是富商千金，网友：李亚鹏的女友一个赛一个！	李亚鹏新女友是豪门之女身价数亿，谢霆锋回应醋意满满！	agreed
聊城的新老司机都应该了解，2018年C1驾驶证最新规定	不系安全带罚1分50元？盘点关于交通违法的那些谣言	unrelated
曹大鹏提出离婚，没想到刘涛这么霸气回复曹大鹏	她长相酷似刘涛，是陈思诚前女友，离婚后的她活出了真正的自己！	unrelated
塑料大米的加工流程	塑料大米的由来	agreed
燃油车停售时间出炉，以后可能不会看到了	辟谣丨北京新能源汽车未停售，上牌近期恢复	unrelated
古力娜扎新恋情被曝光与张翰分手是因恋上吴亦凡？	网曝古力娜扎分手后恋上吴亦凡？工作室辟谣：纯属编造	unrelated
下半年，农村危房改造补贴发放，户均2万元，符合的农民早点去领	辟谣！贵州农村危房改造每户55000元？各地政策不同	unrelated
什么茶的降血压效果最好？几朵绿萝花泡水喝 能帮助降血糖	什么茶的降血压效果最好？每天来杯西藏野生绿萝花 能帮助降血糖	agreed
花样男子：李敏镐带金丝草，飞机上表白，比张翰郑爽的热气球好看	郑爽“表白”张翰视频曝光，郑爽一句话太不“矜持”了	unrelated
网传“女子跳楼未遂看热闹小伙坠楼”，原来男子忧郁抑郁症	“看别人跳楼的小伙坠楼”系谣言 警方：死者患抑郁症	unrelated
双色球头奖号码出号规律提前剧透！要中奖还要看这些胆码！	双色球头奖号码真有规律？把握住这些形态可能中头奖！	agreed
世纪大复合始无定论 林志玲、言承旭被爆真正婚期！	林志玲言承旭又传婚讯,不久忙辟谣,网友:再不结婚我都要结婚了	disagreed
帅小伙吧灯泡放嘴里拿不出来！看美女大夫怎么拿出的？	灯泡吃到嘴里拿的出来吗？除非你有姚晨的大嘴	unrelated
刮肠油暴瘦！减掉啤酒肚大肚腩！	中医瘦身法宝，荷叶加它一起泡水喝，一天一杯，抚平大肚腩	unrelated
纳斯达克将成为数字货币交易所；游戏公司育碧进军区块链	晚报：80家加密货币公司被发传票！酷我辟谣ICO传闻	unrelated
人造假鸡蛋、皮皮虾注胶，这些事儿你都知道吗？	全是谣言：“顶花带刺”不能吃？弯黄瓜不能吃？那还能吃什么？	unrelated
管长个的穴位竟在脚下，睡前按20下就能让孩子不断长高！	晚上失眠睡不着觉？睡觉前按摩这几个穴位，每晚都能安心睡眠	unrelated
潘玮柏与空姐秘恋曝光！两人同晒216万名牌皮箱！	潘玮柏秘恋空姐，两人疑似已同居？吴昕怎么办？	unrelated
强生研制艾滋疫苗引发狂欢！艾滋病到底是怎么回事儿？	“肉毒杆菌”谣言又双叒叕来了！	unrelated
外星人之谜：罗斯维尔外星飞碟坠毁事件	美国政府封锁的UFO谣言（三）：石头打飞碟，外星人尸体	unrelated
汽车尾气比空气干净10倍,机动车对雾霾的贡献并没有那么大	血压高降不下来？常吃这些天然“降压药”，稳定血压清血降脂	unrelated
李小璐出轨真相大反转？她八字还原事实，矛头直指贾乃亮太绝情！	李小璐出轨剧情反转，贾乃亮回应：我对不起李小璐	agreed
白头发染黑长新发后更显眼？教你1招土方法不去染发，自然变黑发	头发染黑长新发白的更明显？传授1招土方法不用染发，自然变黑发	agreed
夏天用这个自制的驱蚊液，蚊子都不敢进屋了，安心度过夏天！	夏天蚊子越来越多，教你自制驱蚊液，天然无毒，家家户户都需要	agreed
花呗套现方法流程是什么 京东白条最新提现方法	支付宝花呗怎么套现 京东白条提现有哪些套现方法	agreed
方舟子说喝普洱茶致癌，吃转基因长寿，对吗？	勿信谣言丨“8月9日3时左右还会有强余震”是假的！	unrelated
独生子女家庭注意，父母有4种补贴可以领取，不要忘记领了！	网传退休人员可领独生子女计划生育奖励？官方辟谣：没这政策	unrelated
王凤雅离世，只因自己是个女孩，其母是否该负刑事责任？	水滴筹转发次数不够无法提现，纯属谣言	unrelated
大清铜币即将在收藏界叱咤风云！一枚价格破百万！	这枚大清铜币存世量不足十枚，原光美品成交价格近百万	unrelated
意媒：北京国安准备5000万欧报价纳因戈兰	迪马济奥辟谣恒大报价罗马中场：双方并未接触	unrelated
别再观望了，最过几个小时，这些降价的手机都涨价了，错过等明年	业内可靠消息，明年国产手机将全面涨价	unrelated
歼20刚服役，西方媒体报道中国六代机，将用人工智能和高超音速	中国首款六代机公开？外媒一致表态：当初小看它了，性能超歼20	unrelated
坐月子必须要穿长衣长裤吗	坐月子的时候产妇一定要穿长衣长裤吗	agreed
胡歌与前女友复合，紧跟薛之谦步伐？	胡歌喊话前女友：若是你复出圈内我们就复合 你们怎么看？	unrelated
新车磨合，你还在拉高速？！	教你怎么拉高速'新车为什么要拉高速	unrelated
情况通报辟谣	西安警方抓获四川地震谣言散布嫌疑人	unrelated
华为手机进货价曝光，看看你买的手机多花了多少钱？	华为裁掉35岁以上的员工，谣言？若是真实你怎么养家？	unrelated
微信更新超重磅功能，让你不花钱就可以上网，一定要打开！	原来微信隐藏了一个wifi功能，开启就能免费上网，不懂真亏	agreed
国产车发动机质量全球排名是多少？第一名却不是德系合资车！	看看这张发动机质量排名：我国在第几？核心部件发展任重道远！	unrelated
红枣千万不要这样吃，等于慢性自杀，千万要注意！	猪肉盖有印章什么意思？不知道的快看，买错了就等于吃毒药！	unrelated
胡歌版《斗破苍穹》第十集：萧炎帮师傅药尘斩杀韩枫，清理门户！	胡歌版《斗破苍穹》最后一集：萧炎，萧薰儿有情人终成眷属！	unrelated
支付宝微信支付最好关掉这个功能，不然银行卡都被搬空	紧急通知！微信支付宝这两个功能赶紧关闭	agreed
开窗通风不是除甲醛最好用的方法，它们几个才是甲醛真正的天敌	柚子皮能除甲醛？辟谣！其实甲醛最怕这几个“天敌”！	unrelated
再见了陆地夫妇，鹿晗公布恋情后，热巴和陈伟霆疑似也好事将近？	鹿晗关晓彤恋情曝光，老婆哭的嗷嗷叫，拉都拉不住，我该怎么办？	unrelated
替人驾驶证销分新规：一个驾驶证只能替3台车销分，违者严重处罚	辟谣！交通新规10月15日开始实施，扣分罚款大升级？假的！	unrelated
特效美白新方法，三天就能白回来！	特效美白新方法，三天肌肤就像婴儿一样！	agreed
监视器拍下奇怪影像 竟看到一个疑似“鬼影”的东西跟在人后面	狗狗街头，叼着东西走来走去，市民奇怪，跟过去一看感动流泪	unrelated
支付宝又一项功能将被关闭，网友：凭什么！	支付宝官方辟谣: 6月30日起, 银行卡代扣关闭为假消息!	unrelated
农村的村干部应该有哪些人来当？看看国家出台的新规	杨洋曝光恋情，女主是她，多少少女哭晕在厕所	unrelated
每天吃几粒它，胜过5个苹果，排毒抗癌防衰老，吃过的都说好！	你听过车前草吗？它可以防衰老，抗癌症，还可以美容，功效很多呢	unrelated
宅基地免税？收费？90%的农民都在寻找答案！	明年起，农村这三种宅基地也要“收费”？农民早知道早做准备！	unrelated
简单说说我怀男宝的孕期症状，有接必中噢	男宝出生7天，这些怀儿子症状可以参考	agreed
2018年农村60岁以上老人的养老金还会涨吗？	谣言｜养老保险缴了15年就不用再缴？医保中断三个月会清零？	unrelated
继马蓉撬门事件后，又被爆出手撕范冰冰！网友：直接起诉马蓉	马蓉撕逼范冰冰被封号后，怒发范冰冰黑历史称内容真实不怕起诉	unrelated
大蒜加它一起吃，防血栓，延缓衰老，一生不得癌症！	女人多吃这5种粗粮，美容养颜更年轻，比护肤品还管用！	unrelated
淘宝首页广告被指性别歧视 吃“碱孕宝”生男孩纯属谣言	淘宝广告被指性别歧视 吃“碱孕宝”生男孩属谣言	unrelated
中国女孩赴韩整容，因为容貌和护照上的照片不一样，被拒绝出境	整容小分队被扣机场！原因：认不出！	agreed
关于开车用车的七个谣言，你一定听过！	挡位越多越省油只是噱头？真相其实是这样的！	unrelated
网传关之琳脑癌病复发 患病已20年一直药物控制	饱受疾病折磨的明星们:关之琳患脑瘤20年	agreed
自制果树杀虫剂，无毒无害，让虫子全部死光	自制果蔬杀虫剂，可杀死各种的虫子无毒无害	agreed
女生吃槟榔会导致不孕吗，女生吃槟榔的好处和坏处	常吃这些食物会导致不孕	unrelated
基础养老金最新好消息：最低标准调整到每人每月88元	最新消息！上海将在4月份涨养老金！	unrelated
痰湿体质克星，减肥每天喝它，3天祛湿排毒，轻松瘦掉大肚子	每天喝1碗，美容排毒，不用节食也能瘦	unrelated
冬天一定要喝这碗汤，强壮身体补肾健脑提高记忆力，养颜还驱寒	记忆力差怎么办 多喝橙汁让你拥有超高记忆力	unrelated
景甜不屑回应背景传闻：我爸不是部长！她的背景不止那么简单！	【图】景甜回应背景说引关注 网友脑回路飞快均称“路转粉”	agreed
想生个漂亮宝宝？爸妈谁的基因决定孩子智商和相貌？	18到45岁台男人生神分析！让男网友泪洒：我对不起爸妈	unrelated
男子想当网红爬火车被电伤，理由令人吃惊	网传济南男子情人节开房兴奋过度猝死，酒店回应：造谣	unrelated
美国试验活体外星人	女外星人 美国终于公布了活着的外星人的视频	agreed
男人千万别吃惯这五种食物，越吃越衰，更加严重的会丧失本能	潘玮柏帽子暴露他真爱吴昕！两人疑是假戏真做正式交往！	unrelated
苏联曾抓获外星人婴儿，腿上长蹼类似水生动物	神奇四侠与军方合力抓获裸身外星人！	unrelated
大咖头条 出轨大戏再次上演！杨幂婚姻遇危机 刘恺威出轨	谣言粉碎机｜跑步瘦身，但是粗腿？	unrelated
朱之文于文华台上唱歌，又搂又抱可气的台下他老婆翻脸，痛哭流泪	于文华去朱之文老家，给他唱了一首肉麻情歌，朱之文老婆当场翻脸	agreed
李天一获超快减刑提前6年出狱，梦鸽满面春光	北京市监狱管理局辟谣：李天一仍在监狱服刑，并未减刑或假释	disagreed
任达华出狱 得知弟弟出事	黑老大任达华出狱，立马带一群小弟，找郑伊健麻烦	unrelated
莆田秀屿区东庄镇7岁女孩走失	家乐福，再见？！接盘的是“企鹅君”	unrelated
做过亲子鉴定的男明星这么多，只有王宝强是例外！	王宝强儿子亲子鉴定出炉 最终印证了网友的猜测	unrelated
猪身上这几个部位千万别吃，不然给自己惹来一身的病！	猪身上这3个部位的肉，卖多便宜也别吃，小心给自己惹一身病！	agreed
4种食物最好不要跟猪肉同食，家里的煮妇看来看看！	山楂消食健胃又能散瘀血。但与这几种食物切记不能同食！	unrelated
30岁保养秘籍：净化血管，延缓衰老，一物搞定！	罗晋与神秘美女举止亲密，似坐实与唐嫣分手传闻！	unrelated
真实存在的芝麻开门!山壁横空出现一道门又自动关闭	国外记者山边采景时拍摄到大山开门 并瞬间关闭	unrelated
未来几年，国家将在农村普及3个项目，一大批农民或将因此富起来	今年起，农村户口取消，3大致富好机会，农民早点做准备	unrelated
和洋葱一起吃，血脂血栓全熔光，高血压的“克星”终于被发现	洋葱和它一块吃，血脂血栓全“熔光”，高血压终结者终于被发现啦	agreed
女生越吃越瘦的减肥食物，减肥女生必看	想减肥少吃点零食，三餐坚持吃这6种食物，想不瘦都难	agreed
农民注意：农村这几种车将会被“禁止”上路，被查出将收处	电动车要完蛋了，很多地方电动车禁止上路，请互相转发！	unrelated
地球日星巴克自带杯免费，然后就	星巴克自带杯免费，那画风太美，我不敢看！	agreed
冰淇淋越不化，添加剂越多？	冰淇淋越不化，添加剂越多	agreed
传说中的“中国龙”竟然真的存在?_	有人居然拍到神龙现身!真实录象	unrelated
浅谈胡可情史，不比范冰冰绯闻少	胡可被曝大学美过baby惹出不少事，黄晓明也曾与她交往过	unrelated
杨澜直接问杨振宁是否接受翁帆改嫁，杨振宁的回答果然是真男人	杨澜提问杨振宁是否允许翁帆改嫁？杨振宁的回答令人意外！	agreed
最近不能晒被子晒衣服？听说飞机来福安撒农药治白蛾？	辟谣：火爆全网的6条护肤神方法，这些都是假的假的假的	unrelated
方便面表示垃圾食品它不是我同类	方便面是垃圾食品吗？营养师是这样说的	unrelated
柏加学生抓龙虾溺亡	她就是泸县6个学生溺亡的谣言制造者！	unrelated
上班就瞌睡？春困来了，中医教你这三招，头脑清醒不犯困	曾经看不起刀郎的那英，首次公开向刀郎道歉，刀郎会原谅她吗？	unrelated
晒黑皮肤黑快速变白的方法——洗澡小窍门快速美白	皮肤美白小妙招 教你快速变身“白雪公主”	unrelated
农村厕所改造补贴最高达4千元，不知道的农民真的亏大了	农村厕所改造有补贴，你家能拿多少？不看亏大了！	agreed
若南宁成为下个直辖市，谁将会是广西新省会？不是桂林也不是玉林	假的！“东北牌照车辆柳州卖冰棍是拐卖儿童？”柳州网警已辟谣	unrelated
42岁变性韩星离婚后晒泳装照秀身材 让金星的露背装变得好尴尬	我懂官方辟谣，泳装照片并非最近大火的克罗地亚女总统	unrelated
水壶底沉积的水垢刮不干净？教你一招，三秒钟让水垢消失无踪	开水瓶底沉积的水垢很厚？教你一招，三秒钟让水垢消失无踪	agreed
朝鲜没有瘫痪关岛的能力	何亮亮：朝鲜全国网络瘫痪 对美网络战完败	unrelated
岑溪市人民医院有人跳楼身亡	「辟谣」网传《地震警示，山东》系谣言	unrelated
什么样的手机号能发财？（数字与命运）——连写第10篇	巧克力吃不黑皮肤，相反还能美白？	unrelated
男孩狂犬病发作学狗叫，只能在家养？症状与狂犬病不符！	“男子狂犬病发作将被执行安乐死”视频流传 警方辟谣	unrelated
张杰谢娜为什么老是被传闻怀孕，离婚？	张杰结婚纪念日宣布谢娜怀孕，不孕谣言被粉碎	unrelated
女性经期真的吃不胖吗？	经常这样做，吃再多也不会胖，肚子一圈圈瘦下来！	unrelated
王思聪放弃网红追腾讯千金，两人机场牵手相约吃饭？网友：我反对	王思聪疯狂追逐马化腾女儿”的谣言：恶意捏造，将追查到底	disagreed
汤泡饭好吗 不仅不好还伤胃	为什么汤泡饭会伤胃而粥养胃呢	agreed
啤酒洗头黑发？不可靠！芝麻加它，一内一外，最快2天白发变黑！	赵丽颖因伤决定暂退娱乐圈,而这个女人竟趁人之危	unrelated
林志玲言承旭又双叒叕被曝复合！这次还惊动了马来西亚的朋友	【正式辟谣！天猫双11不停售，吃瓜群众可	unrelated
男性补肾壮阳的食物，吃什么食物可以壮阳	辟谣：前列腺增生小便难，一定要补肾吗？你可能补错了	unrelated
减肥真的很简单，中医教授教你每天这样喝，刮油排毒，减掉大肚腩	减肥真的很简单，专家教你每天这样喝，刮油排毒，减掉大肚子	agreed
联想ZUK将回归？剑指小米7，将带来真正的全面屏手机！	联想手机要单挑小米！真全面屏发布	agreed
中国将申办2030世界杯？	今年中超取消升降级？足协正式辟谣：完全虚假！凭空捏造！	unrelated
怕怕~网传这些水果都不能吃？真相在这里！	杨梅吐气｜杨梅注胶？泡药水？这些谣言别再传了！	unrelated
洗头发加点它，白发很快自然变黑，再也不用去理发店染发了	洗头发时加点它，白发很快自然变黑发，这辈子都不用再染发了	agreed
经常吃木瓜，不仅能排毒养颜，还能促进头发生长	木瓜新吃法，非常爽口，木瓜还能提升人体免疫能力，促进肠胃消化	unrelated
肩周炎，腰腿疼，枸杞秘制吃法，对付多年腰间盘突出也是妙招	枸杞对于腰间盘突出好处多多，秘制做法，多年腰腿疼痛也管用	agreed
冰淇淋越不化，添加剂越多？	化了又冻的雪糕有毒？戳破这十大食品谣言	unrelated
网上说这样让宝宝吃，会伤害大脑	辟谣：浴霸不会让宝宝眼睛受到损伤？	unrelated
塑料大米生产过程，现在还有什么能吃了	“真相！塑料大米真的存在？”现在造谣都不走心么？	unrelated
实拍：火星上发现外星人躲在一块岩石后小心翼翼查看探测仪	火星竟然发现岩石房屋 那是外星人的家吗	unrelated
潘长江女儿潘阳被曝追悼会，现场照片流出震惊网友死因真相揭露	潘长江女儿潘阳被曝追悼会，现场照片流出震惊网友死因真相揭露！	agreed
今日开始支付宝关闭一项重要功能！以后转账都要咁样做！	熟人可篡改你的支付宝密码？别慌！系夸大描述	unrelated
网传“多人感染SK5病毒死亡”系旧谣新传	「网警辟谣」关于伊春市“撤区设县，撤乡设镇”的消息	unrelated
亚足联服软中国足协！中国球迷多次空场，黑哨裁判法加尼恐遭处罚	巧合还是无视中国球迷空场？亚足联刚宣布4名伊朗裁判参与亚联杯	unrelated
搞错了？卓伟疯了：杨幂不是迪丽热巴的老板而是师姐！胖迪有干爹	真糟心！狗仔卓伟又开始爆料了，矛头直指迪丽热巴，称其有干爹？	unrelated
历史上命最大的鸡，头被砍掉还活18个月，为此还专门给它立雕像	头被砍掉仍活了18个月！有史以来最顽强的生命！	agreed
微信新功能，不用下载软件，免费在线实时翻译各国语言，太好用了	教你一招，微信新功能可以免费看电视直播，赶紧来看下非常流畅	unrelated
满头白发？别去染了，拿它洗头，3天长出乌黑茂密的头发！	头发一天不洗就痒痒出油，洗头时扔掉它进去，不出3天乌黑顺滑	unrelated
咳嗽不用止咳药，只此一招就搞定	一个万能止咳方搞定所有咳嗽！	agreed
爱尔兰一个禁止离婚的国家	韩国小姐姐教你一招能减肚子的瑜伽，你学会了么？	unrelated
网友爆料：谢霆锋为了孩子，再次抛弃王菲，和张柏芝复合！	谢霆锋和张柏芝疑似复合 谢母狄波拉已证实	agreed
曹艳两岁女儿在济宁大润发被拐？谣言！	又一5岁女童被拐？这个谣言这次发生在长沙 你转发了吗？	unrelated
新交通法规2010年4月1日全文	最新交通法规扣分细则2017	unrelated
明天起：汽车年审新规正式施行，将取消5项收费！车主互相转告！	明年起：汽车年审新规施行，取消5个收费项目！互相告知！	agreed
网传保定一名交警发生车祸生死不明	保定网警辟谣｜网传保定一名交警发生车祸生死不明为谣言信息	disagreed
刘明炜高考准考证丢失	「谣言」浏阳一中“刘明炜”同学的高考准考证又丢了？	disagreed
白头发不要染！淀粉这么用，三十年的白头发1夜间变黑！告别染发	再也不要去染发了，这招很实用又健康	unrelated
口臭，口腔溃疡烦不甚烦，我来一招轻松搞定	一招教你迅速去除口臭与口腔溃疡，一次见效，永不复发！	agreed
张继科被爆和马苏有一腿，已被乒联除名	德国男乒内讧致决赛脆败？前中国国手辟谣并无此事！	unrelated
网传海口大英村发生砍人事件？海口网警提醒切勿传谣	猇亭男子朋友圈造谣“杀人分尸案”被拘（法院一周新闻）	unrelated
河南长葛市两人散布银行将倒闭谣言被行拘	仙桃一男子微信群里散布“偷小孩”谣言 被警方依法行政拘留	unrelated
监控实拍车祸现场灵异惊人一幕 疑发光鬼魂闪过救人	奇闻怪事 监控拍下惊人一幕!	agreed
最新UFO飞碟目击录像—NASA泄漏视频证明了外星人存在	拒绝节食减肥，这样吃快速燃烧脂肪，维持血液清澈	unrelated
抽烟到40岁肺部全黑了 睡前喝了它 彻底排出10年烟草毒！	「辟谣」戳穿烟草业的弥天大谎：抽烟真能抽出军费来？	unrelated
《楚乔传2》年底开拍，演员表让人惊喜！马蓉自荐赵丽颖神回复！	马蓉自荐《楚乔传2》女主,赵丽颖回应打脸_	agreed
结婚的时候，你们的房产证上会写谁的名字？	凉凉！房产证上写了你名字，房子也未必是你的！	unrelated
没红时一个样，红了之后就变得目中无人的6大明星	没走红的时候为人低调，红了之后就变得目中无人的5大明星	agreed
严惩！30多人被查实，五人被拘，网络造谣传谣者戒！	咸宁一网民因发布“涉恐谣言”被行政拘留五日	unrelated
江苏新腾化工厂发生特大爆炸	护肤品引起白癜风,大家要谨慎啊	unrelated
口干、口苦，警惕前列腺，洋葱川椒八角加它泡水喝，七天见效！	前列腺别害怕，洋葱配它5天去根，百试百灵，快存！	unrelated
怀孕真的不能吃螃蟹和兔肉？看了这个孕妇的经历，我恐惧了	怀孕期间吃羊肉宝宝会发羊癫？这些谣言你们听过多少个	unrelated
农村老人新增四项补贴金，退休加养老钱一起发！老农民享福了吗？	注意：农民自建房新增四项补贴，有需要的速速申请！	unrelated
汽车尾气比雾霾还干净	「蜡笔小新」小孩子不能喝饮料	unrelated
市教育考试院提醒：高考季网络谣言别中招	高考大谣言1. XX的准考证丢了！“	unrelated
王菲李亚鹏共度中秋复合有望？谢霆锋疑吃醋发文表不满	王菲、李亚鹏复合有望，谢霆锋将何去何从！	agreed
中国驻菲律宾大使馆:菲护照持有人暂停赴华	睡前练习10分钟瑜伽，一觉睡到大天亮！保证不失眠	unrelated
今天早上，狗仔曝光了冯绍峰和郭碧婷的恋情	深扒冯绍峰和郭碧婷的恋情，冯绍峰可能谈了个假恋爱	agreed
范冰冰李晨结婚了!奉子成婚排场大？	李晨和范冰冰准备奉子成婚吗?范冰冰的公开声明竟证明这一切!	unrelated
红枣和它搭着吃，等于“自杀”，你肯定还没了解过！	天冷了，可以贴个暖宝宝 什么，暖宝宝有辐射会致癌！？	unrelated
传周迅买通狗仔封锁婚变消息	赵薇ins晒和周迅合照，力破二人不和谣言！	unrelated
对话旅行の青蛙：火爆背后隐藏是测试使用者的生育意愿？	蛙儿子只是玩家的幻想《旅行青蛙》团队辟谣	unrelated
农村的村干部应该有哪些人来当？看看国家出台的新规	《微微一笑很倾城2》阵容曝光杨洋张雪迎组CP 郑爽被换？	unrelated
手机号可以算出你的年龄	一个手机号轻松算出你的年龄 不信你试试	agreed
人类竟然被外星人囚禁在地球	惊天大秘密!地球竟是外星人囚禁人类所设的监狱	agreed
男人喝豆浆会变得女性化？科学证据是这样的！	喝豆浆致癌？这一谣言套路专家来解锁	unrelated
张一山与杨紫CP要破裂？“刘星”公布恋情	张一山恋情再次被公开 网友：余罪不愧是社会人	unrelated
崩盘了，房子如白菜价，带园子别墅仅卖三万多，仍无人问津	中国房价真的要暴跌？不要幻想了！3大信号道破楼市真相	unrelated
尹相杰终于等到于文华！婚礼现场两人深情献唱，宾客听的掩面痛哭	朱之文婚礼上拉于文华的手深情献唱，尹相杰看吃醋了！	unrelated
网传河池某县抬棺材过桥死19人！	「辟谣」关于网传南阳某小区发生掐死小孩的视频的声明！	unrelated
2018年，部分农村退出宅基地，一亩补偿10万，你会退出吗？	一年内，部分农村地区有“喜事”了！参与就可至少领取10万补偿	agreed
外卖小哥，零晨街头痛哭！	外卖小哥凌晨路边痛哭 背后故事竟如此心酸	agreed
太危险了，青椒与它同吃竟能致命！	太危险了，青椒与它同吃竟能致命	agreed
17岁少女车祸离世，连续几天给父亲托梦，最终决定令人心痛	17岁少女车祸离世，连续几天托梦给父亲，最终决定太令人心痛	agreed
腰间盘突出的“特效药”，枸杞配上它治愈多年腰椎病，绝不含糊！	马蓉又去海口约会？新男友贴心帮提行李，王宝强携两美女下乡养猪	unrelated
宋祖德爆料邓超出轨，邓超这次是不是真的中枪了？	邓超说绝不出轨孙俪，原因居然这么简单	unrelated
有独生子女证的家庭，能领千元补贴？专家解释，每月10元是有的	「辟谣」莱芜有独生子女证的，现在起每年可领到19200元？	unrelated
2017农民不种地也能领补贴	2017农民不种地每亩能领1300补贴？有人说种地补贴更多	agreed
吃蟹黄致癌？！正值吃蟹的季节六安人不看这篇就亏大了！	蒸煮东西不能用自来水？安徽省食药监局：谣言	unrelated
火星曾存在过高级文明！因核战争而毁灭，NASA发现关键证据！	刘强东娶奶茶妹，前妻从美国回来了，还掌权了京东，这场面尴尬了	unrelated
空腹吃水果伤身？请先给我来一筐~	反季水果不能吃？【谣言】夏季结束，“	unrelated
80岁谢贤令女友怀孕 宝刀未老是在给谢霆锋和王菲做榜样吗	王菲怀孕？谢霆锋霸气回答让人惊出一身冷汗！	unrelated
2018年秸秆补贴来了，每项补助1万元到1000万元	秋天皮肤干燥洗脸学会这3招，肌肤越洗越白，几乎被人忽略了	unrelated
「警情通报」网传平顶山市双楼乡麦田发生火灾系谣言	网称郧阳二桥“发生汽车爆炸”系谣言	unrelated
俄方警告：朝鲜半岛若爆发战争将导致“美国不可接受的伤亡”	特朗普德州视察飓风灾情 联邦政府澄清谣言	unrelated
房间放上它，蚊子死光光，还不伤身体！	暴瘦腰腹两侧赘肉，瘦大腿，每天五组，每组四十个，七天暴瘦十斤	unrelated
如果霍建华出轨胡歌，我一定选择原谅他们。并且祝福他们。	白百何出轨后，被强行拉姻缘，宋祖德：你和胡歌很配	unrelated
河道男尸双肾被摘除？三名孩子被撞？假的！	网警辟谣：泰城有道士用迷药冒充洗衣粉推销？	unrelated
你喜欢嗑瓜子吗？原来嗑瓜子也能治病？今天才知道！	老中医告诉你，原来嗑瓜子也能治病？今天才知道！	agreed
公公强吻儿媳后两家人现场斗殴？现场视频系张冠李戴	网传小米8周年纪念版配置单和价格 官方澄清：系恶搞	unrelated
穷人的机会来了，2018抓住这五大行业，傻子都能赚钱！_2	穷人的机会来了，2018抓住这五大行业，傻子都能赚钱！_9	agreed
农民能享受的10大政府特别补助，农村人得知道	现在农业户口取消 农民依然还可以享受各类农业补助吗	unrelated
真人真事，19岁少女嫁42岁老汉，俩人生活在大桥底下	19岁少女嫁42岁老汉，俩人大桥底下“生子”相依为命	agreed
孩子发烧要首选物理降温方式	孩子发热后首选物理降温	agreed
第四套人民币评级币，退市后价格猛涨，快看你手里有吗？	你还在犹豫要不要收藏第四套人民币吗？现在的价格已翻涨多倍！	agreed
柠檬水这样喝才能瘦，快速减肥，不反弹	出生几天就要给宝宝喝中药去胎毒	unrelated
人类可以通过量子态实现永生吗？	谷歌工程总监：人类将在2029年开始实现永生	unrelated
港版天龙八部阿朱卖保险为生 细数境况凄惨的明星	还记得港版《天龙八部》里的阿朱吗？如今转行靠卖保险生存	agreed
六小龄童因和鹿晗同场遭驱赶，转移场地后观众只剩下几人	58的岁六小龄童因和鹿晗撞场而遭驱赶！	agreed
深度剖析薛之谦与李雨桐丑闻微博开撕，薛之谦从此退出娱乐圈？	薛之谦为啥退出娱乐圈？这5位明星朋友的行为令人讽刺！	unrelated
宋祖德曝周星驰儿子已经10岁 跟风卓伟？娱乐圈两大毒瘤	周星驰有10岁儿子？盘点冒出私生子的明星	unrelated
农民注意了，农村这些人的户口会被注销，土地也会被收回！	注意啦！农村这些农民的户口会被注销，土地也会被收回！	agreed
不求客服，不用投诉，如何简单方便办理移动8元保号套餐	应该快了！联通回应改套餐传言：老用户依然不支持，正在优化中	unrelated
和迪丽热巴cp已下线 鹿晗新电影女主竟是她!	钟汉良新戏《沙漏》，待定男女主竟是鹿晗郑爽？网友：必定爆红！	unrelated
少女节食减肥不吃晚饭，俩个月廋10斤成胃穿孔	不吃晚饭最减肥？谣言大揭秘！	disagreed
“食品谣言”何以每次都能“妖言惑众”？	辟谣：昆明已有3167个人吃杨梅、李子感染SK5病毒？假的！	unrelated
土豆可以给手机手机充电？看完再也不怕没电了！	《三生三世枕上书》开拍惹期待，杨幂迪丽热巴比美，最亮眼不过他	unrelated
范冰冰疑似怀孕，李晨升级当奶爸，什么时候大婚呢？	一夜惊喜：范冰冰竟意外怀孕，居然还不知道孩子是谁的	unrelated
紫菜是塑料做的，粉丝也是塑料做的，塑料君最近真的好忙	你想看的“塑料大米”谣言这里通通都有	unrelated
182斤减到101斤，柠檬泡水喝，减掉十斤肉，赶快了解下	月子期婆婆老妈死活不让洗头洗澡，身上都快臭了！	unrelated
老农的疑惑：为啥城市一户多宅合法，而农村房屋却不能随意买卖？	城里人可以合法一户多宅，农村房屋却不能随意买卖，到底是为啥！	agreed
吃大盘鸡、泡椒凤爪能感染H7N9？	辟谣｜深圳男子因吃大盘鸡感染H7N9死亡？这是谣言！	unrelated
吃货们注意了，晚上吃它，等于是自杀！	这四种食物吃进去，等于慢性自杀	unrelated
49岁大妈巧用白醋洗脸，坚持用两次，皮肤水嫩细腻，年轻10岁	穿开裆裤 危害居然这么大！宝妈注意：宝宝夏季穿开裆裤坏处多	unrelated
她是黄晓明伤的最深的人，如今43岁成国民婆婆	胡可黄晓明分手原因是什么 总觉得胡可不够爱沙溢	unrelated
滴滴打车近日体验越来越差，会倒闭吗？	空姐刚过去，滴滴又出现垃圾人物，滴滴公司面估计临倒闭	unrelated
伊利公告称董事长潘刚在国外治病，将缺席今年博鳌亚洲论坛	金色财经陷入“微博门” 官方辟谣：图片系诽谤	unrelated
特斯拉有计划在广东独资建厂 厂址都选好了	特斯拉拟在广东独资建厂 联姻腾讯未出“蜜月”	agreed
茶叶水加它洗头，不管白发多凶，三分钟漆黑似墨，告别染发	洗发水和它混合洗头，白头发会越来越少，再也不用花钱去染发了！	unrelated
女人在外面干了“坏事”，会有这4个表现！	“夜深了，女人有这三个表现，说明她在外面偷吃了，你懂吗”	agreed
苹果手机恢复大师：苹果手机如何恢复微信聊天记录	苹果手机删除的微信聊天记录如何恢复？	agreed
武警新式武器惊艳了，不用手枪用弓弩！	喝白开水不能乱喝，当心喝出癌症！（转给家人看看）	unrelated
几颗花生这样吃，6天刮去8斤油，24天瘦了27斤，不反弹	饭前这样吃花生，7天瘦5斤，月从132瘦98，健康不反弹	agreed
发生了什么？陈奕迅宁愿被骂没良心，也不愿意复活这位学员！	陈奕迅爆料新歌声内幕，有学员无限复活！	unrelated
微信提现又免费了！网友：都是马云的功劳	支付宝壕发10亿红包遭质疑，官方辟谣：那码能是假的？	unrelated
爆料｜魅族启动大规模年中裁员 规模2000多人	魅族员工辟谣新Logo 变相承认魅蓝将分家	unrelated
腰间盘突出，千万不能小看它！自我治疗很简单，用这方法	自我治疗法，轻松简单去除腰间盘突出	agreed
普洱茶=致癌茶？ 广东省疾控中心抽查结果竟是......	普洱茶会像方舟子说的那样致癌吗？	unrelated
广电全网封杀郭德纲，究竟为何？	收不到推送，德云社相声被封杀？谣言！真实原因了解一下	disagreed
一分钟教你给手机快速充电，手机充电速度能提升一倍	赵丽颖逼婚何炅，遭谢娜调侃：你是确实爱他还是借恋情炒作？	unrelated
姚明被赞当年拒签丰田1.6亿代言合同，为何女儿却入美国国籍？	姚明提案全被否？篮协辟谣：根本没人提案 完全没这事	unrelated
夏季快速减肥，天然减肥食物这样吃，两周抹平小肚子，便秘也好了	夏季快速减肥食谱推荐：苦瓜健康减肥法	unrelated
火箭已经超越勇士，登炮还要迎第三巨头！第一中锋就差直说去休城	一门心思想去NBA还是媒体炒作？火箭辟谣：未向周琦发邀请	unrelated
潭下三名未成年人在公平乡被绑架	男人补肾壮阳吃一种海鲜最有效	unrelated
宋祖德微博称西安到昆明高铁坠桥 12306：没有开通	7月份开通，从西安可坐高铁直达昆明！	unrelated
不想外出的农民注意了！今年农村这3个项目，做好了绝对比打工强	2018大批农民要致富了 国家启动3大农村项目 快来看看吧	agreed
农村退伍军人在哪里，这些补贴你领到了多少？特别是老红军战士！	河南农村退伍老军人吹奏唢呐，这唢呐吹得真好听！	unrelated
世卫组织把65岁划为青年	刘诗诗回应，承认自己怀孕，网友：原来女神回家养胎去了！	unrelated
农村土方专治脚气，用个脚气偏方只要几毛钱，根治脚气从此不服发	洗头水加点橘皮，巧用3分钟白发变黑不反弹，不再染发花一分钱！	unrelated
农村新增了以下几项补贴，补贴高达万元	下半年开始，农村新增的这三项补贴，共计上万元你有吗？	agreed
美军黑鸟侦察机差点被中国导弹部队击落，制造原料竟是从苏联进口	泉州网警辟谣“四川震前黑鸟乱飞”：画面拍自美国	unrelated
王者荣耀团队年终奖是100个月工资？！腾讯回应了	王者荣耀辟谣：S10奖励皮肤官方并未确定！回应你们的是个假号	unrelated
保释后首现身！高云翔顶光头穿紧身T状态很好	高云翔方辟谣，网上流传的“高云翔保释后现身”照片系谣传	disagreed
新交规注意了！喝酒没开车也算酒驾！	车震真的毁车么？朋友里的谣言 哪些行为会对车辆有不可逆的伤害	unrelated
偷天换日，主力资金重仓抢筹此20只股，明日直冲涨停后登龙虎榜	30只强势妖股遭到主力资金疯狂抢筹，有望连续暴涨直冲龙虎榜！	agreed
水壶底沉积的水垢刮不干净？教你一招，三秒钟让水垢消失无踪	电热水壶表面污垢难清洗？教你一招，水垢自己掉下来！	agreed
慎重！楼层高低影响寿命？买房之前先看这个	楼层的高低会影响你的寿命？住哪层楼寿命最长？	agreed
儿子已出生，7.1斤重，整理怀孕期间症状	儿子已出生，预产期早了三天，分享经历和症状	agreed
杨洋继鹿晗之后公布恋情，不是郑爽也不是李沁，居然是她	郑爽谈恋爱了，要公布新恋情！网友：比张翰胡彦斌强多了！	unrelated
抢恒大“绯闻”外援！国安5000万欧元挖纳因戈兰！何去何从？	拉尔夫辟谣：我不会离开国安 还想在这待更长时间呢	unrelated
健康的“第一杀手”是它！就在你我身边，想远离，只有这一个办法	辟谣：网传甲醛的释放期长达15年是真的吗?有科学依据吗?	unrelated
三星口碑国内暴跌，依旧屹立不倒	三星面临“闪存门”压力？完整的产业链优势秒摧谣言	unrelated
明年起每车都得配备反光背心，“偷”换车标的小心点！	“汽车没有天窗更安全”？！这些汽车的谣言，你信吗？	unrelated
张柏芝与小男友何孟怀即将大婚，谢霆锋心酸回应：她过得好就好	谢霆锋七个字祝福张柏芝即将大婚！	agreed
老汉海滩发现奇怪生物，靠近后报警求助，专家也表示没见过！	女子家中发现一撮“头发”，扒开一看才知道是成群的奇怪生物	unrelated
10年高血压，一古方，治一好一个，1月后血压稳降，请存！	食疗，10年高血压，张仲景一古方，治一好一个，1月后血压稳降	agreed
刘亦菲怀孕？韩媒抛出怀孕线索 宋承宪都亲口承认闪婚	刚传出刘亦菲怀孕，宋承宪就宣布分手，还说出这话，真是渣透了！	unrelated
人民的名义2：公布演员阵容，网友直呼-比第一部还完美	《人民的名义2》最新演员名单出炉，阵容豪华，你要追吗	agreed
宁波楼市今起限购限贷	保定徐水区楼市限购政策升级：本区居民调整为限购2套	unrelated
农村退伍军人养老补贴，最高可领五万元，符合条件别忘记领？	部队纠察真的是鬼见愁？退伍提前离队防止挨打？都是谣言	unrelated
九种人吃辣等于慢性自杀！快看有没有你	香蕉和这几样东西一起吃，等于慢性自杀，你知道吗？	unrelated
夏季湿气重，车前草煮水喝，祛湿排毒	湿气的克星车前草，这样煮茶喝，祛湿真管用	agreed
五五开承认小号开挂，斗鱼官方选择性忽视，真当用户是傻子？	斗鱼吃鸡主播雪MM被封账号解封，微博辟谣没开挂顺手抽个奖	unrelated
痛风病人能不能喝豆浆？营养师：这三种饮品，痛风病人喝完就后悔	辟谣｜美女喝鼠尿啤酒后丧命，罐装饮料不能对瓶喝，真的吗？	unrelated
企业退休人员养老金13连涨，比机关事业单位低一半	重要通知：明年企业养老金将超过事业单位的一半，你怎么看？	agreed
一把花生顶过十副药，高血压不用烦，降低血压有奇效，记得存！	高血压不要慌，一把芹菜顶过十副药，轻松降压防三高，为家人存着	unrelated
王菲面临出局危险？谢霆锋被曝夜宿张柏芝家四昼夜，画面太美！	霆锋患皮肤癌？张柏芝不管不问，王菲却这样做？难怪谢霆锋爱王菲	unrelated
尹相杰出狱后跟于文华合唱第一首歌，朱之文听了伤心欲绝哭到断肠	尹相杰单身18年为等于文华，出狱后再次合唱这首经典朱之文心醉	agreed
无核葡萄用避孕药，吃了会绝育？！	肉松棉花做？食品安全谣言为何屡热传	unrelated
一不小心就会买到地沟油，教你一招，轻松辨别地沟油！	一招辨别地沟油	unrelated
女人腰部赘肉多，常吃这几种排油食物，刮油燃脂，让你想不瘦都难	脂肪最怕的6种食物 饭前吃一点燃脂刮油一整天	agreed
芯片第一龙头56跌至6元，主力六度加仓，有望成为新一代妖股	芯片第一龙头50跌至6元，主力六度加仓，有望成为新一代妖股	agreed
8种白发的“克星”，经常吃这些，让你白发变黑发显年轻！	孕吐反应强烈？这也许是生男预兆，孕妈来对比一下这些生男症状吧	unrelated
国际空间站实拍UFO飞碟离开地球瞬间 精彩影像	实拍UFO拖蓝色光尾穿越云层：犹如科幻大片	agreed
7月1日将会实施个人外汇新规	外汇局辟谣：7月1日没有个人外汇新规	unrelated
林志玲怀孕了？看她怎么说的！	林志玲凸肚疑有喜 助理辟谣：因打抗生素变圆润	unrelated
2018年全面取消农村户口，农民朋友必须要注意的三件事	急！农村户口将取消！农民朋友抓紧办好4件事，越晚越吃亏…	agreed
不想接电话怎么办简单一招让你手机变空号	不想接对方电话？老师傅教你一招不用关机，手机秒变空号！	agreed
苏打水能中和胃酸	微直播 奇幻科学城 当人体的胃酸分泌过多时，喝苏打水	agreed
大多数人都喜欢这么吃鸡蛋，可不知道吃多了“致癌”	家常吃鸡蛋，这些错误可能“致癌”，别不当回事	agreed
催熟的香蕉会导致孩子性早熟，是真是假，家长要知道这几个问题	催熟的香蕉会导致儿童性早熟？无稽之谈！还是听听专家怎么说	unrelated
严惩！30多人被查实，五人被拘，网络造谣传谣者戒！	一男子传播“电表谣言”被行政拘留	unrelated
范冰冰的弟弟是私生子吗？真相：其实是她的一个阴谋	范丞丞庆生私生子谣言不攻自破！网友：羡慕这一大家子	disagreed
NBA哪些事被吐槽最多？詹皇抱团仅第2，科比鹰郡事件登顶！	健康小知识：隔夜馒头不要再吃了，会导致癌症	unrelated
吴京《战狼2》票房飙破40亿，冯小刚躺着也中枪，刘德华大赞！	吴京澄清谣言：一周前就收到冯小刚徐峥祝贺视频，造谣者已道歉	unrelated
挖出大型地宫，考古队凿开金刚墙后乌云密布，墓中冒出个白色东西	考古发现孙悟空墓 孙悟空真的存在于古代吗？	unrelated
最奇葩的宣传，这种没有轮子，悬浮的汽车你见过么？	悬浮汽车已经上路，可离地行驶！	unrelated
江铠同被曝插足陈翔毛晓彤感情后首现身机场，网友：光腿不怕冷吗	陈翔发声明辟谣“出轨”，网友看完文章却心疼毛晓彤！	unrelated
白酒泡这个，8年肾无力，居然好了，为健康加油，为自己收藏	桂圆别吃泡白酒喝，8年肾无力，竟喝好了，精神十足！	agreed
原来这简单的三种水果核竟可根治糖尿病	常吃这三种东西，可有效预防糖尿病，一生拒绝高血糖.mp4	unrelated
白酒和它泡一起，颈椎、腰椎、膝盖骨痛全好了！多年腰腿疼也管用	花椒泡白酒，偏方治大病，有效缓解腰腿疼痛预防关节炎	agreed
吴卓林出柜窦靖童躺枪，只是两人的区别还是蛮大的！	窦靖童周冬雨合体现身某夜店，网友：她俩出柜我可以接受	unrelated
范冰冰4.5亿豪宅曝光！网友惊呼：根本是大型商场	范冰冰未归国，美国豪宅出售？律师澄清谣言	unrelated
王菲李亚鹏外出破镜重圆？谢霆锋赶紧表态，他心情沉重	谢霆锋和张柏芝、王菲和李亚鹏双双对对破镜重圆，难道预言是真的	unrelated
女性减肥，每天按这几个地方就可以！舒服高效瘦身	中医用拔罐的方法减肥，每天拔一次，一次瘦半斤！	unrelated
喝茶能够清肠排毒还能减肥？这种说法靠谱吗	胃不好的人不能喝茶？是时候好好辟谣了	unrelated
王大陆与漂亮女助理搞暧昧，搂肩搭背家中独处6小时	景甜迅速发胖？赵丽颖冯绍峰再传绯闻？王大陆和女助理暧昧？	agreed
仓库意外拍到诡异镜像，疑似外星人！	妖女被抓被当众上火刑，在烈火中痛苦不已，黑发变白发！	unrelated
歌坛又一歌后患癌病逝，留下这首千古绝唱，葬礼上韩红悲痛抹泪	胡杏儿怀孕后狂吃才是女人真正怀孕的样子，鼻子变大可能生男孩？	unrelated
空姐独家祛斑美白小秘诀，睡前仅用它敷敷脸，一周皮肤光滑嫩白	大姐教你用这个露自制祛斑面膜，还你嫩白光滑皮肤	unrelated
三明一楼房倒塌现场辗压死了好几个人	葡萄皮加上它洗头，3天后白发自然变黑，长出头发乌黑亮泽！	unrelated
刘强东扬言要甩掉马云三条街，马云、我从来没把京东放在眼里 2	刘强东扬言要甩掉马云三条街，马云、我从来没把京东放在眼里 4	agreed
七个妙招护肤防辐射绿茶橘子抵御电脑辐射	保健：防辐射1橘子2绿茶	unrelated
以后会取消中、小学教师职称工资？教师工资收入构成！	教育部：特教教师工资收入将提高	unrelated
橙县警局:月圆之夜犯罪率上升	乌头草盛开的月圆之夜 ——自然环境对犯罪的影响	agreed
47岁张庭机场近照遭曝光，网友：厉害了林瑞阳！	是真的！张庭喜怀第三胎！与丈夫恩爱牵手，全家幸福现身机场	unrelated
可乐致癌之说从何而来	常喝可乐会致癌吗？凶手是谁？	unrelated
湿气克星，每天一杯一身轻	醋泡黄豆，每天吃几粒，15天瘦10斤，30天减掉大肚腩	unrelated
爆李易峰吸毒，影响挣钱可就不好了	张卫健辟谣 张卫健吸毒了吗被传吸毒很生气发文否认	unrelated
不起眼的护发能手，白发的“克星”，常吃一吃，延缓白发生长速度	白头发的“克星”来了！每天吃一点这几物，白发悄悄变回来	agreed
经常翘二郎腿，等于慢性自杀？跷得不好真会影响脊柱	翘二郎腿等于慢性自杀，你知道吗？	agreed
四川成都昨天半夜黑社会火拼,死伤一地	血溅一地!四川黑社会街头火拼全程 似港匪片	agreed
手指的长短决定你的命运，看出你的性格	第四根手指的长短胖瘦，决定你一生婚姻财运好坏	unrelated
巴中现“100元感谢费骗孩子上车带路”？是谣言	被专柜小姐骗了N年，皮肤营养过剩就是个谣言！	unrelated
农村违章用地要整治了，这些情况下可领补贴，这些情况下无偿回收	政策鼓励农村土地流转，那么农民土地流转补贴是多少？	unrelated
舒淇新戏杀青宣布退出娱乐圈，被疑和冯德伦造人成功！	舒淇疑怀孕宣布退出朋友圈，为什么网友让她别回来？	unrelated
芒果台跨年晚会名单，自家艺人撑台，有刘德华，没有谢娜	张柏芝和王菲到底谁才是谢霆锋的最爱？这些小细节透露了答案	unrelated
穷人的机会来了，2018抓住这五大行业，傻子都能赚钱！_0	马云透露： 2018做这个必定赚钱，穷人翻身！	agreed
感染sk5病毒死亡来袭，云南省红河州第一医院躺枪	红河蒙自：散布猪肉有病毒谣言者被行政拘留	unrelated
微信悄悄出新功能！网友：千万不能让女友老婆知道！	微信悄悄出新功能！网友：千万不能让老婆知道……	agreed
房间放洋葱可以防流感	谣言粉碎机｜用洋葱杀死感冒病毒？不科学！	unrelated
中国最后一位压寨夫人杨丙莲，96岁颜值依然美艳动人！	中国最后一位压寨夫人：16岁自愿嫁土匪，容貌惊艳世人至今健在	agreed
意大利医生换头手术将实现人类永生，首位实验者为中国人	人类永生实现了！基因化粉末投入太空可永生，现场被疯抢：我投资	unrelated
痔疮难受又尴尬？教你一简单有效的方法，肉球脱落痔疮不复发	农村一偏方，马齿苋+鸡蛋，治好30年的痔疮，神了	agreed
微信提现终于可以免费了！网友：马化腾什么时候变“大气”了？！	网友不希望吴京拍摄《战狼3》原因竟是！	unrelated
《真正男子汉》第三季嘉宾阵容确定，除易烊千玺外还有他们哦	《真正男子汉》第三季开录，嘉宾阵容曝光！	unrelated
菜板洗不干净致癌？老师傅教了我一招，用它清洗让菜板干净如新！	菜板细菌会致癌-只要用它正确清洗菜板干净又杀菌！	agreed
男子怀疑二婚妻子出轨 分居两年后要求离婚｜《咵天》	聂远被曝与妻子已分居数月 携神秘女子街边亲密互动	unrelated
当你看完这些，你还会给自己家宝宝穿开裆裤吗？	「谣言粉碎机」谁说宝宝夏天穿开裆裤凉快的？	unrelated
教师主要的九笔工资收入，你能收到几个？	教育部：特教教师工资收入将提高	unrelated
为当网红不要命！重庆一男子拍抖音，惨被高压电烧伤！	温州火车撞人了？上周末热传的这段视频竟是以讹传讹	unrelated
瘦肚子不用愁，只需这四物煮水喝，轻松瘦掉游泳圈，来试试	梨和蜂蜜这样吃，轻松刮油瘦肚子，21天轻了15斤	unrelated
井柏然要离开郑爽，郑爽大哭，以为不要她了！	井柏然要离开郑爽，郑爽大哭，以为不要她了	agreed
昌吉东方广场走丢了小女孩	谢娜狂删张杰微博原因有三，天天秀恩爱离婚了吗	unrelated
王者荣耀团队年终奖是100个月工资？！腾讯回应了	王者荣耀辟谣：露娜机甲新皮肤是假消息，模型再来其他游戏	unrelated
“斗鱼一姐”冯提莫被曝已结婚，继天佑之后被广电封杀的主播	广电公布第二批封杀名单冯提莫因“吞物”上榜，网友：天佑不孤单	agreed
冯小刚迁怒成龙现场动手，张国立圆场，吓坏李冰冰！	日常辟谣啊哈哈哈哈哈哈哈哈 冰块并不能使油凝固啊？	unrelated
农村瘦身良方，一把香菜煮水喝，通便消脂刮油瘦肚腩，谁用谁瘦	减肥就要土方法，只需一把香菜，甩掉大肚腩瘦到两位数	agreed
UFO目击报告：在英国和美国看到的UFO最多，中国最少	最新UFO飞碟目击录像——谁能解释这是什么？真的有外星人？	agreed
农村这种野草就是克星，专治腰腿痛、坐立不得！腰间盘突出也管用	腰间盘突出危害大！农村地边上的一把野草解决，关节炎也管用！	agreed
令人脸红的旅游景点，新西兰内衣墙，女游客集体在这脱衣！	64岁关牧村再提前夫痛苦不堪疑家暴，面容沧桑惨不忍睹	unrelated
大蒜和它一起吃，比人参鹿茸还要补，连吃三天壮如牛，效果胜牛鞭	大蒜跟它一起吃，比吃牛鞭人参还要补，连吃三天壮如牛，男性必看	agreed
减肥没有那么难，阿姨教你每天这样喝，刮油排毒，减掉大肚子	减肥土方子，每天一杯，排毒刮油减肥，常喝还能美容养颜	unrelated
火星上的古老外星人：好奇号发现疑似动物雕像和奇怪的人工制品	好奇号发现：火星有人造炮弹，暴露了外星人争夺火星的野心？	unrelated
最喜欢红烧鲶鱼，朋友说鲶鱼是最脏的鱼，不能吃？	烧水壶水垢证明水质差？水务开放日实验辟谣	unrelated
《辛普森一家》的十大预言！细思极恐，16年前就预言川普当总统	编剧都是穿越回来的，辛普森一家神预言川普当选美国总统	agreed
微信这个功能你知道吗？一键就能查看好友的精准位置！	定位妙招：通过微信请能知道对方的位置，非常精准几秒就学会！	agreed
“国民贤妻”刘涛为老公5年还清4亿巨债后，首发声：我后悔了	刘涛5年了刚刚为老公还清4亿巨债，首发声我后悔了	agreed
王健林直言：只有她有资格当万达少奶奶！可是表示都没想到是她	王健林直言：只有她有资格当万达少奶奶！网友看后都没想到是她	agreed
买到这种西红柿扔了也别吃！有致癌风险！	屁股大好生娃？头发长抢营养？谣言而已。	unrelated
曹云金回击郭德纲晒收据：27岁的你在诈骗	曹云金回击郭德纲 晒收据 27岁的你在诈骗我的钱财	agreed
四平东郊一小区内有加工黑实蛋的作坊	新消息：农村将大力开展环境整治，农民能够拿到这些补贴了！	unrelated
冰箱里打死都不能放的6种食物，放进去就得扔，许多主妇却还再犯	主妇们经常犯的错误，冰箱里打死都不能放的6种食物，拿出就扔	agreed
朝鲜网络一度瘫痪 美国拒证实是报复	最适合夏天的减肥方法，排毒清肠，轻松月瘦20斤	unrelated
双色球第059期头奖出号有规律 单挑一注冲击1000万	价值连城的古钱币为什么越来越难出手	unrelated
四种食物，美容排毒又养颜	【专题辟谣】香甜软糯的八宝粥变成了“碎海绵”？真相在这里…	unrelated
肿瘤专家说出养生秘诀：每天8杯白开水，癌症远离你！	饭后喝凉水会得癌症？医生盘点4个喝水“骗局”！	unrelated
孕妇剖腹产时被医院偷肾？所谓“丧尽天良”，其实是旧谣新传	网警辟谣：“金乡经济园有人偷小孩”？谣言！	unrelated
大S又又又怀孕了！确认怀上第三胎，您快来找好孕妈妈。	媒体曝光大S第三胎是男孩，汪小菲辟谣并6字吐槽他们没文化！	unrelated
1换1伦纳德加盟骑士死敌，交易如达成，东部冠军真没詹姆斯什么	火箭太抠被猛龙劫走伊巴卡！骑士交易已刻不容缓但恐代价太大！	unrelated
不吃晚饭能减肥吗？不吃晚饭有害身体健康	「健康」别听信谣言！不吃晚饭，对健康毫无益处！	unrelated
毛宁入狱，杨钰莹哭到断肠为他唱这首歌，毛宁在狱中哭的捶胸呐喊	毛宁入狱，杨钰莹撕心裂肺为他唱首歌，毛宁在狱中哭的死去活来	agreed
王宝强被曝又一神秘女友浮出水面，两人关系密切不一般	王宝强女友曝光!素颜甩马蓉十条街,身份更惊呆我	unrelated
孩子智商高不高？还得看在一岁左右有没有这4种表现	孩子长的高不高，其实这2个部位看到出	unrelated
王思聪炮轰那英，将其赶出娱乐圈	王思聪炮轰那英，让她滚出娱乐圈，网友：终于出手了！	agreed
2017年第一只妖股太阳电缆（002300）的诞生！	波场被质疑操纵市场，高位出货；孙宇晨辟谣，归咎做市商不专业！	unrelated
手机埋进大米里，一次能省下不少钱，后悔才知道，真的很实用	手机放进大米了太厉害了，一次帮家里省下上千元，看完一定要试试	agreed
《前半生2》女主不是马伊琍，另换其人？	食物相克系列：好吃的苹果与那些食物不宜一起吃呢？	unrelated
生男生女有哪些秘诀，哪种方法最靠谱？	二胎生男生女，掌握夫妻间的这些小秘密	agreed
可乐的“致癌危机”	揭密：一个月不喝碳酸饮料会有哪些惊人变化？可乐是否有致癌一说	agreed
孕妇剖腹产时被医院偷肾？所谓“丧尽天良”，其实是旧谣新传	中学生被割肾系谣传！谣言散布者被拘10日	unrelated
吴奇隆刘诗诗两人去日本求子，想生一个狗宝宝！	白发越长越多不用染，淘米水加它洗头，白发3天自然变黑	unrelated
娱乐太八卦，陈乔恩和吴磊恋情曝光，只有智障才会信	肚子的肉越来越多，几颗花生睡前吃，轻松瘦下来	unrelated
你知道吗？经常让孩子嚼口香糖可提升学习记忆力，还有健齿的作用	tag你的猪朋友！!LOTTE推出了救救记忆力口香糖	unrelated
彭于晏出柜 赵丽颖成为继应采儿之后娱乐圈又一预言家	辟谣：“越野车掉入壶口瀑布”纯属假消息	unrelated
国产悬浮汽车即将上市，趁未上市前先睹为快	悬浮汽车，原地调头自动操控，科技感十足	unrelated
合肥房价暴跌业主求政府救市！央行再出手，厦门楼市将……	厦门警方查处“楼市调控政策放宽”谣言，当事人被拘	unrelated
尼坤宋茜2017公开恋情 昔日恩爱恋人如今变陌生人令人惋惜	在一起了！陈伟霆发文公开恋情：用尽一生遇见你	unrelated
春节假期银行系统维护，1月24日是信用卡还款最后期限	朱之文母亲去世，于文华在葬礼上唱了这首歌，全村人哭的泪流满面	unrelated
爱干净也会惹祸，这些情况下绝不能给宝宝洗澡	坐月子不能给宝宝洗澡	unrelated
国外男子在51区小屋发现外星人，用手机对它拍到这一段视频！	印度出现五头眼镜蛇，吓坏路人（高清）	unrelated
网传“多人感染SK5病毒死亡”系旧谣新传	百度公关辟谣“李彦宏小三”传闻：百分之百谣言，已报案	unrelated
茶水加它一起洗头，坚持三天，满头白发逐渐变黑，再也不用染发了	枸杞加它这样用，满头白发变黑只要三天，再也不用染发剂！	unrelated
手机竟能验钞！这些隐藏功能大部分人都不知道	手机相机真的可以验钞？专业人士：简直是笑话	agreed
做好这几步护肤工作，吃辣不长痘！想吃就吃	曾毅刚离开凤凰传奇，玲花和老公重组合唱这首歌，曾毅撕心裂肺！	unrelated
农村取暖补贴，最高补贴一万元，很多农民为什么都没有领到？	黄光裕带黑哥重出江湖，马云的阿里巴巴将成为国美的垫脚石？	unrelated
《写给未来的你》，值得所有孩子一看	重读《写给未来的你》——余光中先生写给他女儿的文章	unrelated
曝光！这25股目标涨幅超50%，下周将引领暴涨狂潮！	机构上调12股评级 视觉中国目标涨幅50%	unrelated
“小黄车传艾滋病”？谣言！都是谣言！	澄清｜运城疾控中心公车私用事件 实为会议用车！	unrelated
你真的会刷牙吗？刷牙前牙膏要不要沾水？原来我白刷了23年牙	刷牙前还把牙膏蘸水？难怪容易牙黄口臭，正确的刷牙方法更健康	agreed
成都一女子跳楼未遂 对面看热闹的小伙反倒失足坠楼摔死了！	女子跳楼未遂，看热闹的人却失足摔死 一起悲剧挽救另一场悲剧！	agreed
张柏芝带俩儿子回港，锋菲机场大吵，谢霆锋高调接机，她失声痛哭	张柏芝带儿子返回香港，差点和谢霆锋在机场遇见	unrelated
2018事业单位改革：这类事业编，每满2年可直接转公务员！	香蕉浸泡“不明液体”,吃了有毒?	unrelated
tfboys斩获大奖也难合体，难道真的要解散了？	TFBOYS要解散?王源已成立个人工作室	agreed
全家人吃了泡发木耳，全部死亡，赶紧扔掉	一家人吃了泡发木耳，全部死亡，家里有的赶快扔掉	agreed
半年内使用网贷超2次，拒贷！怎么办？	辟谣：针对“公积金贷款纳入征信”等不完整信息的公开说明	unrelated
31省份GDP一季度成绩单：18个省份增速跑赢全国	2亿2的投资变成17亿，谁在造谣骅威？	unrelated
2017年农村土地新规，这几种土地要缴税了，看看有没有你家的	清热去火穿心莲，排毒减肥又养颜，你吃对了吗？	unrelated
绝地求生：卢本伟首次承认帐号开挂！但是开挂的不是自己而是他！	五五开直播道歉，并不打算承认自己开挂，卢本伟到底凉了没	unrelated
明察｜大连警方：正侦破特大杀人案，网传行凶视频与本案无关	网传“杏山坡加油站爆炸” 新泰警方辟谣	unrelated
买房千万别买这4种阳台的房子我非不听劝住进去犯风水隐讳了	千万不要买这几种阳台的房子！	agreed
注意！2018国家公职人员喝酒开车可直接开除，子女发展受限！	辟谣｜为公号吸粉虚构交通事故，造谣者被刑拘5日	unrelated
火箭赢下G5已成定局？休城喜迎第三巨头归位，哈登保罗压力大减	辟谣！森林狼还没有想象中那么差	unrelated
最新教程：教你恢复安卓手机删除的聊天记录	你以为你的聊天记录真的删除了吗？只要打开这里，就能给你恢复	unrelated
监控拍到的恶鬼袭人真实恐怖录像——科学还无法解释！你相信吗？	监控拍到的恶鬼袭人真实恐怖录像 科学现还无法解释！你相信吗？	agreed
曹艳两岁女儿在济宁大润发被拐？谣言！	网传“河北邢台发生水灾”是谣言！请勿传播！	unrelated
中国到底做了什么？日本企业全体撤资中国，群众一脸懵呆！	它被称“天然美容”食物，每天吃一吃，美容养颜气色好	unrelated
《中国新说唱》终于定档，23强名单提前出炉，谁会“燃烧一夏”	KT上单Smeb与AD选手Deft传不和！当事人实力辟谣！	unrelated
儿科医生告诉你：怎么通过晒太阳补钙才能让宝宝长高？	育儿辟谣系列十一：宝宝配方奶真的要喝到三岁吗？	unrelated
当年梅艳芳葬礼上，张柏芝因这件事被人痛骂，成为一辈子的污点！	怀孕5个月的刘亦菲 与宋承宪的婚礼还会远吗	unrelated
保利尼奥为赌博网站宣传或被驱逐出境？对方违约 回应：将解约	卖掉保利尼奥？巴萨功勋队长普约尔一番言论强势回击可笑谣言！	unrelated
懂明珠透露，2018年最赚钱的行业，傻子都能致富 2	懂明珠透露，2018年最赚钱的行业，傻子都能致富	agreed
原来鉴别翡翠的好坏还有这么简单的方法	教你鉴别红酒真假最简单的方法，百分之百有效	unrelated
开车忘带驾驶证别慌，这3种情况不算无证驾驶！老司机偷偷告诉你	忘带驾照=无证驾驶？别再被谣言忽悠了！	unrelated
国宝级美声歌唱家，朱之文崇拜他，与妻子结婚40多年恩爱如初	朱之文现在名气越来越大了，很多有钱人家里结婚都会请他过去~	unrelated
牙克石公安局招辅警、交警、法警、刑警、狱警	“地震云”到底算不算是地震前兆？	unrelated
好消息：今年农村4项补贴可以领取了，每月有300块，你符合吗	好消息：独生子女，国家将给予4项特殊津贴，将近1万元！	agreed
心理学家：你的血型决定了你的性格	血型决定性格，性格决定投资方向？AI+血型+投资	unrelated
一个清理血管壁垃圾的有效方子，为家人转发	1个简单方子，将血管壁清理得干干净净	agreed
可以靠自由职业赚钱月入过万的人，都有这一个特点 3	可以靠自由职业赚钱月入过万的人，都有这一个特点 2	agreed
宁夏交通违法“清零”行动今天开始！详细解读在这里→	5月必吃的蔬菜，防癌抗病促消化，每天吃一点，身体棒棒哒！	unrelated
美国军队禁用华为和中兴，如果中国禁售苹果，谁更惨？	谁在造谣“美国封杀中国手机”？	unrelated
十年鸡头如砒霜？医生建议：这8种肉最好别吃	别把翅尖作尖翅 两者有毒皆谣言	unrelated
吴奇隆不能生育吗 吴奇隆两任妻子都没有小孩原因揭秘	吴奇隆不能生育吗？吴奇隆两任妻子都没有小孩原因揭秘	agreed
减肥新方法，多揉这个穴位，减肥养生，助你甩掉大肚子	减肥真的很简单，农村阿姨教你在家做减肥茶，轻松甩掉大肚子	unrelated
315晚会：螃蟹加西红柿等于吃砒霜？看看专家实验怎么说	震惊：螃蟹加西红柿等一起吃等于砒霜 真的是这样吗？	agreed
李亚鹏为了女儿，希望和王菲复合，网友：女儿太像老太太了	王菲中秋携女赴德国与李亚鹏汇合，这是要复合的节奏？	unrelated
王菲跟谢霆锋是因为怀孕才选择复合的吗？	谣言！华晨宇的女朋友竟然不是邓紫棋？	unrelated
怀孕多久穿防辐射服 孕妇如何选购	怀孕了，一定要穿防辐射服吗？	unrelated
「涨知识」微信悄悄出新功能，千万不能让你老婆知道！	微信悄悄出新功能！千万不能让女友老婆知道！	agreed
儿子女友竟是46岁的杨钰莹，鲍国安的反应令人很意外！	这是要复合的节奏吗？王菲和李亚鹏谢霆锋和张柏芝，双双对对出现	unrelated
她曾四次上春晚三次患癌，央视主持人朱迅的坚强人生	央视一姐第三次癌症复发，面部变形无法再登上舞台，惋惜！	unrelated
江苏高考“炼狱模式”将结束？语数外改为全国卷，网友：可喜可贺	网传葛军将参与今年高考数学命题！网友：没有根据，已经辟谣	unrelated
网传海口大英村发生砍人事件？海口网警提醒切勿传谣	别传谣！海口商场有人打群架？朋友圈相关视频或涉假	unrelated
丈夫干家务越多,离婚率竟然越高!	男人干家务越多离婚率越高	agreed
紧急扩散！手机勒索病毒来了！	王者荣耀谣言粉粹机：剑仙要重做成辅助？呵呵呵呵呵	unrelated
4种职业容易导致男性不孕不育，5种常见水果良药来预防	被爆欠薪不给，还不孕不育？吴奇隆怒斥网友：谣言猛于虎！	unrelated
范丞丞恋情被扒出，女友是富二代网红，范冰冰会同意吗？	王一博辟谣追求豪门千金綦美合，富家女和明星合照传绯闻	unrelated
夏天蚊子最怕这种植物！家里摆两盆，蚊子不敢进屋，清新养眼	夏天蚊子最怕这种植物！家里摆两盆，蚊子不敢进屋，美观实用	agreed
公公强吻儿媳后两家人现场斗殴？现场视频系张冠李戴	网传沙坪坝一小区发生杀人案？警方发布警情通报辟谣	unrelated
网络热传的左右脑年龄测试靠谱吗？	又上当了！左右脑测试辟谣后，网友神回复亮了	unrelated
腰间盘突出久治不愈，试试这种方法，轻松治好腰腿痛	夏天蚊子特别多，家里放上这个没有一只蚊子	unrelated
以后这些补贴会直接打入农民账户！你还不知道吧	征地补贴直接打入农民账户，农民朋友你是否知道？	unrelated
OPPO R13曝光：但背面是iPhone X吗？	林志玲隐婚两年	unrelated
发烧物理降温	发烧38度了该怎么进行物理降温给生完孩子的大人？	unrelated
廊坊网传飞机撒药治白蛾 市园林局：假消息！	网传“飞机洒药”假通知 郑州园林局辟谣：没这回事儿	unrelated
你坐火车时见过火车司机吗 你知道他们工资多少吗 说出来吓死你	原来火车司机的工资这么高，一个月居然上万元	unrelated
不挨饿，不疯狂运动，14天甩掉10斤肉，她是如何“吃”瘦的？	回拨“响一声”国际电话会被扣巨款	unrelated
她是前斗鱼一姐，被冯提莫赶下台后生活窘迫，如今挑粪劈柴样样来	破除谣言！斗鱼内部人员回应：大司马不会离开斗鱼！网友：成了！	unrelated
《老九门2》即将开拍，张艺兴有望开展新恋情，启月夫妇要凉了	南派三叔透露《老九门2》将开拍，这阵容你看吗？	unrelated
花生黄曲霉真致癌吗，为何上几辈人吃都没事？	“花生的红衣”要慎吃！花生米制品可致癌！	unrelated
怎么做才能提高生男孩的几率呢？想要儿女双全看这里！	怎么备孕可以增加生男孩的机率？	agreed
别给宝宝这么吃草莓，易感染诺如病毒，已有孩子中招！	孕妇吃薏米虽易引发流产，但合理食用可以改善肤色又下奶	unrelated
吃珍珠等于吃塑料警惕奶茶中成分	吃珍珠等于吃塑料警惕奶茶中5种成分	agreed
吴亦凡被曝吸毒，受访期间摇头晃脑	吴亦凡辟谣吸毒传闻，他为啥频频被黑？	disagreed
专家教你减肥妙招，这2物一起熬水喝，刮油排毒，体内脂肪全扫空	169斤减到98斤，专家教你这样喝，刮油排毒，快来了解一下	agreed
孕妇孕期常吃这些食物，宝宝一出生就近视，你们还不改？	刚出生的宝宝被确诊痴呆儿，孕期这种食物还是尽量少吃	unrelated
吴亦凡颖宝公开恋情，人气堪比鹿晗，林更新粉丝纷纷表示：凭什么	赵丽颖吴亦凡公开恋情？网友：俩人隐藏的够深，大家都被骗了	agreed
李连杰谈生病坐轮椅传闻:我有病但没坐轮椅	李连杰亲自分享工作近况澄清病重衰老谣言：未来我还会做得更好	unrelated
五五开承认小号开挂，斗鱼官方选择性忽视，真当用户是傻子？	pdd正面回应开挂谣言，将所有账户送给吃鸡官方检测	unrelated
微信这个功能你知道吗？一键就能查看好友的精准位置！	打开微信这项功能精准定位别人手机位置只需3秒	agreed
科学使用空调小技巧，每月省电20%	十多元的“节电器”可省电20%	unrelated
一分钟教你给手机快速充电，手机充电速度能提升一倍	赵丽颖恋情曝光？对方竟是杨幂前男友？	unrelated
怀孕期间喜欢吃酸的，铁定生男孩？科学的解释在这里	吃生蚝能增加生男孩几率？	unrelated
“小黄车传艾滋病”？谣言！都是谣言！	今晚廊坊永清有余震纯属谣言 公安部门正追查谣言源头	unrelated
外卖小哥雨中送餐，车被偷了大哭，哭的是生活还是什么？	高血压的克星！一招轻松降血压，不反弹	unrelated
粤港澳+国资改龙头，主力260亿锁仓，主升浪开启目标60%	深国改+粤港澳第一龙头，主力15亿锁仓，十个板完全不是问题！	unrelated
成都水淹地铁通道 拉货小哥改拉人	辟谣：拉货小哥地铁通道扫码拉人？这不是在成都	unrelated
农村违章建筑来消息了，有的可以免税，有的还可以享受补贴了	在农村这些违建现在可以合法了,并且还免税!	agreed
缺乏谦卑！余承东再度回应闪存门事件：现在有了反思	华工程师辟谣：从未听谁说过秒杀苹果，余承东更不可能	unrelated
曝“尔豪”扮演者高鑫携女儿与神秘女逛街，已经与王一楠离婚？	高鑫：有人来探前妻的班 网友：你什么时候离婚又再婚的？	agreed
王健林说出对儿媳妇的要求，王思聪慌了！网友：全国只有一人符合	主持人问首富王健林：对儿媳妇有什么基本要求，首富回答亮了 7	agreed
芯片第一龙头沉睡7年，中报净利飙增千倍，4月或赶超科大讯飞	芯片第一龙头沉睡7年，中报净利飙增千倍，五月或赶超科大讯	agreed
男人吃腰子、牡蛎真能“壮阳”吗？营养师：你被这3种食物骗惨了	猪肉扔一边，今天就吃它！腰子怎样才能去腥味美味一看就学会	unrelated
南京苏宁球迷上吊自杀	今夏南京雨水多蚊子也会多 别让谣言误导你	unrelated
今夏减肥的妹子需警惕，这几种水果要少吃，不然越吃越胖	8款营养又好吃的水果干，减肥的你也能吃	unrelated
肩周炎，腰腿疼，枸杞秘制吃法，对付多年腰间盘突出也是妙招	腰腿僵硬，行走困难，枸杞巧妙吃法，多年腰间盘突出患者也管用	agreed
世界艾滋病日｜我们离治愈HIV还有多远？	辟谣：滴血验癌不可能 马赛克疫苗不能阻止艾滋病	unrelated
厉害了国内75岁大爷发明隐形衣，穿上瞬间消失？	马云讲未来十大领域 暴富的行业一定是它震撼！	unrelated
2018公职人员喝酒开车可直接开除，子女发展都受限	注意！2018国家公职人员喝酒开车可直接开除，子女发展受限！	agreed
独生子女的你，房产继承为何一波三折？	即使是独生子女，你也不一定能单独继承爸妈的房产！	agreed
王晓晨“整容”相当于毁容！网友：莫非是为了胡歌？	人红是非多，“王小米”王晓晨被疑整容，再看完这些旧照就有数了	agreed
李亚鹏有了新恋情？李嫣反对，王菲无所谓！	章子怡微博公然叫板整容谣言者；想挨揍就吱一声！	unrelated
男人不要经常吃这四种食物，越吃肾越衰，严重的丧失本能	这四类食物，男人不要多吃，越吃身子越差，可能丧失本能	agreed
口臭，口腔溃疡烦不甚烦，我来一招轻松搞定	一招去口臭，口腔溃疡	agreed
撕得这么难看，张杰谢娜要是真的离婚了就是那些毒唯们害得！	谢娜辟谣：没逛公园没直播，以前是直发现在是短发	unrelated
瓜帅发声，梅西真要去曼城？逼宫高层，巴萨动荡何时结束	巴萨主帅辟谣：暂未收到小白任何报价，但一切都可以讨论	unrelated
天哪！日本科学家最新研究显示，麦当劳竟然可以治疗脱发？！	喝酒驱寒、吃薯条治秃顶…这些养生谣言信了就是害自己！	unrelated
《跑男》被下令停播整改，李晨成最大原因，网友：收视率惹得祸	《奔跑吧》被下令停播整改，李晨成最大原因，网友：都是为了收视	agreed
沐浴液内含防腐剂诱发乳腺癌？	绿萝真的会开花吗？不要再被那些谣言欺骗了！	unrelated
洗澡时间太长易致癌吗？	真的有这么神奇？多种方法让你彻底摆脱“白发”烦恼！	unrelated
用热水泡脚？是慢性自杀！（看完我惊呆了！）「经典收藏」	还在用热水泡脚？请好好听，这是慢性自杀~	agreed
捡到这3种石头千万不要丢，虽然外貌很普通，但它们的价值却很大	赌石，男子路边捡了一块石头，开出帝王绿暴涨五千万！	unrelated
肚子一把肉，懒人1招减肥瘦肚腩，坚持一月瘦20斤！	三个月瘦了40斤，不用节食就能瘦，健康瘦身	agreed
湿气的“死对头”,晚上吃几口，湿毒祛的一干二净，体重也降了！	湿气的“死对头”,晚上吃一口，湿毒祛得一干二净，体重也降了！	agreed
好消息：2018年这类补贴将直接打入农民的账户，有你吗？	2017年新农业补贴政策出台，这项补贴是直接打入农民账户！	unrelated
洗发水一定要买无硅油的	生男孩的科学方法，生男孩秘诀	unrelated
冬瓜加个“它”，7天快速美白，15天让你的肌肤雪白细嫩	2017年起驾驶证年龄新规定，算算你还可以开几年车	unrelated
农村房屋倒塌，宅基地将被收回？这些人却能获得数万补偿！	网传平江加义镇五星水库坍塌导致多人死亡 房屋倒塌等消息系谣言	unrelated
农村小伙野外巧制陷阱，结果，收获喜人	农村小伙野外巧制陷阱，不一会，就有猎物上钩，一只黑色的大鸟！	agreed
快速补气血，七天告别黄脸婆的小妙招！喜欢的朋友关注分享哦！	七天告别黄脸婆，还保养卵巢！	agreed
白头发别染！大米水和这种洗头三分钟，不超过六次白发变黑了	白头发别再去染了，1碗土豆2杯水用来洗头，白发半月变黑	unrelated
关于杨钰莹要结婚的消息，甜歌皇后首次微博公开回应	就知道是假的，关于坚果pro的销量老罗终于辟谣了	unrelated
皮肤干燥、起痘、毛孔粗大想什么呢？还不清洁下你的枕头和被子！	皮肤粗糙毛孔大？还不快快来吃素！	unrelated
艾叶加白酒，腰腿疼痛走光光，夏天效果好15倍，千万别错过	艾叶加白酒，腰腿疼痛走光光，千万别错过	agreed
自制多种水果酵素!美容养颜排毒!	春季女人养生必吃的金牌水果，补水排毒养颜，少吃一样都可惜	unrelated
曹艳两岁女儿在济宁大润发被拐？谣言！	2岁女孩大润发附近被拐走？南通网警辟谣：假的！	unrelated
两名女子偷孩子？网警辟谣：假的！不要转发谣言	辟谣：朋友圈传的“免费领取一百元超市购物卡”的消息，假的	unrelated
恒大！前拜仁主教练安切洛蒂确定执教广州恒大，就差官宣	恒大新教练定了！名记姬宇阳爆料：就是安切洛蒂！	agreed
真的有些食物孕妇一吃就流产吗？	孕妈吃螃蟹会流产居然是谣言？孕期正确吃螃蟹的姿势是什么？	unrelated
申花夺足协杯冠军，续约莫雷诺，躺冠特维斯决赛日已回阿根廷	吴金贵愤怒驳斥申花在亚冠上替补是为留力战上港的谣言	unrelated
潜伏期20年的癌症——肺癌，你知多少？	海外医疗：别相信用手机致癌这类谣言！	unrelated
三国时期最流行的小吃，过年吃更吉利，现在最火的小吃	凤梨最早起源于中国的三国时期	unrelated
秦始皇苦苦寻觅的长生不老药，2015年被一农民无意中捡到	汪峰发新歌，恰好古天乐郭采洁公布恋情，头条注定是别人家的头条	unrelated
未找到原谣言文章，或已删除	长期上网有损记忆6个习惯加速记忆力衰退	unrelated
不吃药不花钱不忽悠, 我用真实经历帮你治好灰指甲	灰指甲患者受困擾五年，親測農村偏方，七天告別灰指甲	agreed
周立波出事之前的事，吓的一身冷汗！	周立波说：马云拜访谁！谁就会出事，究竟马云都拜访了谁？说得准	unrelated
甲醛最怕这2个“土方法”，一用一个准，让你28天入住新房	甲醛清除剂可以一次性清除甲醛？十种方法，九种谣言	unrelated
支付宝花呗怎么套现 怎么提现靠谱	蚂蚁花呗对比哪个套现方便提现过程怎么完成	unrelated
海口飞机撒药治白蛾	3月谣言盘点：飞机撒药治白蛾、驾考新规，你中“谣”了吗？	disagreed
白醋加几滴它兑温开水调配，排毒减脂，1天喝3杯，1周瘦7斤	教你一个减肥的小妙招，不用运动，天然食品每餐坚持喝就可以了	unrelated
最牛的“天然胰岛素”，糖尿病的天敌，常吃降低血糖一身轻	农村不起眼的天然“胰岛素”，糖尿病人常吃，降低血糖气色更好	agreed
已确认！鹿晗关晓彤将在央视春晚中同台表演，网友：还真是高调啊	原创｜春晚主打“青春”路线？鹿晗关晓彤夫妇同台？还有李易峰？	unrelated
网传潘长江女儿已去世，本人却突然发微博	前两天还在走红毯的潘阳被传已离世 潘长江愤怒辟谣	disagreed
央视315晚会之夜 汽车大佬秘密聊天记录遭泄露	狗年春晚，刘德华或将登台演唱，你期待吗？	unrelated
庐江县校车侧翻死亡人数升至5人？教育局辟谣：仍为2人死亡	洪涛离职湖南卫视？下一季歌手要黄了哪？如果是真的还真有点不舍	unrelated
凤凰传奇解散了！玲花含泪唱了这首歌，观众哭的撕心裂肺，太扎心	凤凰传奇解散了？这不还和朱之文一起参加群星演唱会	unrelated
为了让中国多买几批，俄罗斯的苏35战斗机做了一次万里巡航！	俄方及时交付订购苏35战机，直接粉碎西方媒体散布推迟交付谣言	unrelated
猎奇！世界上最奇葩的20种水果，吃过5种以上的绝对土豪！	六月一定要多吃这几种水果，暴发户都在吃，吃过超3种你也是土豪	unrelated
最大股票回购案：美光科技回购100亿美元股票 股票跳涨！	美光发布澄清声明：晶圆厂故障并非氮气泄露引起	unrelated
华为因联想坚持所谓“良心”把票投给高通，丢失5G标准	5G标准没投给中国企业主导方案？联想：这是谣言！	unrelated
农村补贴大调整，未来这些农民可能拿不到补贴了！	日系发动机质量排名，究竟哪个质量好哪个质量差！	unrelated
沐浴乳含有的paraben使用十年恐诱发乳癌	飞碟UFO不明飞行物目击录像，外星人也许就生活在地球！	unrelated
猪蹄这样吃才叫爽，一次一只，对付膝盖疼，腰间盘突出有妙招！	婆婆这样做猪蹄，不仅营养美味，对腰间盘突出也管用！收藏吧	agreed
揭秘李湘吴昕退出《快本》原因，如今谢娜也将退出？	谢娜宣布出国深造，网友呼唤：娜姐生娃？《快本》紧急辟谣	unrelated
手机屏幕满划痕不要担心，涂上点牙膏轻松搞定，非常实用的小窍门	牙膏竟然可以修复手机屏幕！牙膏的几大妙用	agreed
微信恢复聊天记录的小技巧，再也不担心老公删微信聊天记录啦	微信聊天记录删除了怎么恢复？简单详解	agreed
你家的古钱币不知不觉已价值百万，你还不知道！	为何如今一枚古钱币价值百万？	unrelated
只需要这一招，美白再也不是难题，整个夏天都不怕晒黑	教你一招美白牙齿，去除牙渍，烟垢	unrelated
一个月吃两次保证你神清气爽！豆腐鸭血！清肺排毒防雾霾啊！	揭秘八大食疗谣言：鸭血不清肺、喝茶不减肥！	unrelated
中医减肥小秘方，只用3粒山楂，刮油排毒，帮你减掉大肚子	韩红与管彤在美国秘密结婚卓伟不敢惹事回答很坚决	unrelated
李天一提前6年出狱？然而时隔5年，女受害者如今却活成这样	李天一提前出狱？梦鸽挂电话拒绝回应	agreed
如果蜜蜂消失，人类只能存活4年？这真是一个大危机！	如果蜜蜂消失，人类将只能存活4年	agreed
皮皮虾又火了 这次是因为被曝光“注胶” 全国吃货哭笑不得	市场上真的有“注胶”的皮皮虾呀，潮汕大地可都是真材实料哦	agreed
新鲜银杏叶泡水喝可降血脂？	肚子大得像怀孕？只需一瓣大蒜，谁用谁瘦，水桶腰瞬间变成A4腰	unrelated
手机屏幕满划痕不要担心，涂上点牙膏轻松搞定，非常实用的小窍门	窍门妹：手机屏幕刮花2分钟修复如新的小技巧	unrelated
刘诗诗与吴奇隆婚后久不怀孕，刘诗诗含泪诉说缘由让人心酸	刘诗诗怀孕已被证实，推掉工作回家养胎	unrelated
如果oppo和vivo有一个必须倒闭，那么你希望是哪一个？	印度军工业实力如何，真的连子弹都不能造吗？我们都被谣言骗了	unrelated
猫狗绝对不能吃的27种人类食物	红薯被称为蔬菜冠军，但千万不能和这7种食物同吃，果断收藏	unrelated
住院超15天无法医保报销	胡歌新欢旧爱一起上是因为要结婚？其实大家都错了	unrelated
张柏芝回应“柏芝与小十岁鲜肉男星大婚”，一切只是恶意捏造？	张柏芝工作室回应张柏芝大婚传闻：纯属人为恶意捏造，是谣言！	disagreed
戒不了烟怎么办，每天喝一杯这个饮品，体内烟毒轻松排出	全球第一条会说话的狗，震惊60亿人，简直不敢相信！10	unrelated
打针西瓜致人中毒	这样的西瓜不能吃，教你分辨打针瓜	unrelated
土豆皮加它洗头，白发3天快速变黑，这辈子再也不用去染发了	洗发水和它混合洗头，再也不用去染发了，头上一根白发都找不到！	unrelated
《奔跑吧》天津录制占用图书馆惹争议，大学生发怒：滚出天津！	天津大学录制遭拒！跑男导演姚译添在凌晨发了一条意味深长的微博	unrelated
前列腺别害怕，一把八角5天去根，一用一个好，百试百灵，快看！	前列腺别害怕，一把八角3天去根，一用一个好，百试百灵，快看！	agreed
大蒜还在泡着吃？这样吃，一头大蒜就能轻松解决前列腺炎	大蒜泡酒还能这样吃，三天解决前列腺炎，收藏	agreed
7年腰间盘突出和坐骨神经痛，农村村医一个方子就给我治好了	不花一分钱，治腰间盘突出的农村偏方，治一个好一个，快来试试！	unrelated
秀恩爱的范冰冰李晨要结婚了，北京豪华婚房首度曝光，岳母已入住	范冰冰、张馨予同一个错误，李晨却和她分手，给范冰冰买婚房？！	unrelated
卓伟公开表态黄毅清爆料非常真实？马苏做头发实锤了吗	揭秘！悟空问答假的？卓伟辟谣：没入驻平台，没在上面回答问题！	unrelated
肝病患者有这5个症状很危险，下一步就是肝癌！	如果肝脏发生毛病了，身体会出现这三种症状，严重的可能诱发肝癌	unrelated
真正男子汉3嘉宾名单 这些明星是真的都要来参加吗	原来腿上有个穴位，每天按8分钟治百病：滋阴补肝，祛邪湿降血压	unrelated
恶霸光天化日抢小孩，败家少爷和刘涛现身教训恶霸	男子光天化日在佛山小区抢小孩，被众人围堵	unrelated
实录：UFO最真实视频大集合 -国语流畅，外星人真的存在	学生如何快速减肥 5个减肥方法健康瘦身	unrelated
刘德华雨中演唱，和歌曲绝配！跨年晚会如果有这一段绝对火爆！	张柏芝谢霆锋家庭聚会，原来是和王菲夫妻生活不和谐？	unrelated
净网2018「揭西警讯」揭西公安机关依法处置一宗谣言案	关于澄清谣传“普定老农贸市场执法人员打人”的公告	unrelated
是时候给食品界的老大哥“罐头”正名了	冷藏牛奶最新鲜，常温奶全是防腐剂？这个谣言该破了！	unrelated
各地“5月29日自来水厂更换高压线路，全市停水”均为谣言	5月29日全市停水？谣言！	unrelated
伊利发声明：董事长潘刚身体仍在治疗恢复，无法出席博鳌论坛	伊利:造谣董事长被带走调查的一名涉案人员已被抓捕归案	unrelated
翻版范冰冰何承熹老公余小泉婚内出轨	翻版范冰冰前夫余小泉发辟谣声明：没有婚内出轨同性	unrelated
住院超15天无法医保报销	男神胡歌和薛佳凝再续前缘？是否如网友所说在美国领证结婚	unrelated
唐嫣与罗晋闹分手只因孙坚，两人在微博竟秀起了恩爱	唐嫣深爱前任，情伤治愈，与现任男友罗晋低调分手？	unrelated
李连杰生病严重，表示想回国安葬！又一位功夫巨星要离开我们了！	又一位功夫巨星要离开我们了，李连杰病情严重，表示想回国安葬！	agreed
微信隐藏代码，输入马上精准定位，太神奇了，赶快试试吧	才发现微信上这个隐藏代码，输入马上精准定位，不会微信真白玩了	agreed
张柏芝要给孩子改姓，谢贤回应惹怒谢霆锋	张柏芝称将孩子改姓为张，谢霆锋回应太无情，爷爷谢贤霸气回应	agreed
你以为吴京表情是演出来的？他可是喝了17扎啤酒3两白酒啊	这啤酒喝到哪里去了，鼻子里都出来了	unrelated
媳妇每天都滴2滴风油精在肚脐，半个月后身体发现奇妙的变化	媳妇天天都滴两滴风油精在肚脐，半个月后身体有了奇妙的变化	agreed
继离婚风波后王宝强和马蓉首次“私会”，这是要破镜重圆？	宋哲这样安排王宝强档期的目的，竟是为了与马蓉私会	unrelated
我区严厉打击网络谣言零容忍	龙海某地发生血腥命案？龙海警方官微紧急辟谣	unrelated
洋葱加上它洗头有奇效？白发不白了，头发不掉了，最快3天马上好	白发不要染，洋葱加它洗头，再多的白发也不怕	agreed
猜宝宝性别丨酸儿辣女、看妈妈肚子……这些方法你一定试过	口腔谣言粉碎机：年龄大掉牙是正常的？	unrelated
终于找到洗葡萄最干净的方法，残留农药去光光，还能消菌！	葡萄用水冲，相当于没洗，教你一招，残留农药全洗掉	agreed
传销窝点再次被端，不料胡歌侥幸出走，男秘书成了替罪羊！	电视剧猎场被指抄袭，编剧姜伟怒斥谣言并起诉造谣者	unrelated
人无横财不富，马无夜草不肥，手相有三条手腕线，中年后横财致富	手有二婚线的人，定会婚姻不顺	unrelated
印度的这个生男孩的秘诀很特别	想生男孩的秘诀，房事的这几点很重要，接好孕！	unrelated
《跑男》最新片酬曝光，郑恺垫底，邓超第三，第一不是鹿晗	鹿晗公布恋情时，关晓彤就在身边，跑男还要组团消费迪丽热巴？	unrelated
深圳GDP已超过新加坡和香港，是人才红利释放的原因吗？	广东最有潜力的城市，GDP稳超新一线，不是广州，也不是深圳！	unrelated
杨紫和秦俊杰似分手？天哪！太不可思议了！	杨紫和秦俊杰甜蜜 90 后情侣疑似分手……	agreed
农民每亩土地补贴1600元，你领了没有？	农民朋友注意了，土地补贴新标准出炉，每亩1500你买账吗？	unrelated
尹相杰为她至今单身一手捧红朱之文结婚两次	一手捧红朱之文，结婚两次，尹相杰为等她至今单身，女儿貌美如花	agreed
你知道赵薇和马云到底啥关系，看完你就知道了	揭秘：赵薇与马云到底什么关系 6	agreed
娱乐早知道：网传被判41年 周立波发声明-一切安好	周立波持枪藏毒被判41年？发声明喊冤怒斥谣言！	unrelated
怎么查看情人微信上己经删除的聊天记录？	老公出轨了,要怎么查看他已删除的微信聊天记录了？	agreed
以色列海边实拍-美人鱼-受惊跳入水中过程！	男子在海边调戏食人族，却被海里的食人美人鱼给吃了！	unrelated
柠檬水你会喝么？这样处理，堪称女性夏季美白佳品！	柠檬水的9种喝法，每天一杯，美白又瘦身！	unrelated
倪萍说到退出央视原因飙泪，你知道多少呢？	倪萍退出央视后竟然转行当了画家，一幅画价值百万不止！	agreed
王宝强携手宋喆前妻拿回尊严，宋喆进监狱坐实，杨慧回应：感恩	王宝强与宋喆前妻，送宋喆进监狱，宝强拿回尊严，杨慧回应：感恩	agreed
2018新交规：喝酒没开车也算酒驾，同样扣分罚款	“2018新交规：酒后躺车内休息也算酒驾”是谣言！	unrelated
田娃多次说赵家班内幕，赵本山冷淡回应10个字，网友：缘分已尽	田娃屡揭赵家班丑事, 赵本山终于发怒, 10个字回应田娃!	agreed
2018京东白条闪付套现秒到方法	花呗套现 京东白条套现方法 蚂蚁花口贝套现支付宝花呗怎么套现	agreed
49岁大妈巧用白醋洗脸，坚持用两次，皮肤水嫩细腻，年轻10岁	幼儿保健全面解析宝宝要不要穿开裆裤，你家宝宝中招了吗？	unrelated
冰淇淋融化的越慢，添加剂就越多吗？	老婆每天都往肚脐里滴两滴风油精，两周后后身体发现奇妙的变化！	unrelated
张翰公布最新恋情，女友帅气可爱有气质！郑爽娜扎还是另择良偶吧	林丹出轨事件背后的真相！	unrelated
娱讯：冯小刚赞吴亦凡，郑爽巧遇牛骏峰，张歆艺前夫，王思聪米咪	郑爽的前夫	unrelated
「微知识」“乙烯利”催熟的香蕉到底能不能吃？	乙烯催熟香蕉，膨大剂催大西瓜，致癌？文科生这智商也敢造谣	unrelated
周润发在微信发了个红包，竟引来了半个娱乐圈明星疯抢	周润发在微信发了个红包，引来了半个娱乐圈明星疯抢	agreed
娜扎张翰宣布分手两个礼拜，却传出了三段恋情	娜扎张翰分手却和吴亦凡传绯闻？无中生有！谣言何时休止？	unrelated
孕期嘴馋不用忍！常吃这3种零食，宝宝头发乌黑，身体更健康！	杨幂围观征服异性技巧再引离婚说	unrelated
几块钱一斤的减肥方子，泡杯水喝一个月瘦20斤！	肥胖太丑？几块钱一斤的减肥方子，泡杯水喝一个月排毒甩油瘦9斤	agreed
张杰这样对待谢娜，难怪娱乐圈一直传着你们两离婚的绯闻	宋祖德说谢娜与张杰明年年底必定离婚！还说卓伟是小狗狗上蹿下跳	agreed
哇！公鸡唱歌真牛逼，我们都来听一听！	公鸡中的战斗鸡！唱歌就是好听！	agreed
男蛇 女龙 生什么属相宝宝最好？	辟谣：狗改不了吃屎，不是因为他们爱吃……	unrelated
想想都刺激！360手机和锤子科技正在洽谈合并？360锤？	网曝锤子新机谍照有假 罗永浩亲自辟谣	unrelated
朱婷年收入两千万 修路+养老院+希望小学 她捐出1200多万	朱婷父亲斥责谣言：败光2000万是假新闻	unrelated
不管何时取消农村户口，农民朋友首先要将这两个证办好！	农民注意了：市场卖韭菜要是没有这两个证，最高罚款五万元	unrelated
五一后，农村这四类东西可能要涨价，农民最好提前囤货备用！	今年农村过完年，这些农民常用的东西将要涨价	unrelated
两个多月暴瘦40斤，不节食不反弹，懒人方法	不节食不运动！健康甩肉25斤，停歇10个月不	agreed
摩拜或将击溃投资人信息，《人民的名义》现实版上演	摩拜曝出互联网最大回扣丑闻 供应链厂商神补刀起底摩拜真实成本	unrelated
什么样的手机号能发财？（数字与命运）——连写第4篇	不想让宝宝遗传自己的黑皮肤，孕期多吃这个！	unrelated
宜兴骑电动车的赶紧看看！以后可能骑电动车也要考驾照了？！	家有电动车的赶紧看！国家终于出手了 你可能要考驾照了	unrelated
红枣和它一起吃相当于“服毒”，很多人却浑然不知！	这3种食物千万别和红枣一起吃，看完一身冷汗，进了医院就晚了	agreed
有钱人买房从不选这几层？开发商不会告诉你的秘密，看完才知多坑	买房万万要注意这几个楼层，内行人一看就懂了，买过的都知道坑	unrelated
糖尿病可以吃什么水果？	适合糖尿病可以吃的5种水果	unrelated
小米汽车要来了？这售价让人疯狂，太便宜了！	小米要造汽车？价格超低：北汽小米了解一下！	agreed
她因美貌签入杨幂旗下人气大涨，被质疑整容，清纯甜美气质佳	杨幂手机贴纸暴露出，她是女儿奴！远比刘恺威更爱糯米	unrelated
唐嫣罗晋恋情告急？分手传闻大起底	唐嫣出轨孙坚？《归去来》成罗晋与女友分手作，发布会现端倪！	unrelated
狂犬病发作的人为何会学狗叫科学家这样说的	2018一季度谣言热度榜出炉，微信付款码 狂犬病学狗叫等上榜	unrelated
牺牲了王鸥，差点让她背负小三骂名，谁来为此买单？	王鸥是第二个姚笛吗？在演艺圈做小三也太危险了！	agreed
国家出手，农村房屋管理新规定，村干部将带头拆除这几类房屋	不运动不节食懒人瘦身法：亲测10天瘦8斤，完全不节食受罪	unrelated
2017会计证取消了怎么办？会计从业资格证取消了吗？	谣言观察｜会计从业资格证考试取消了？学会计的怎么办	unrelated
杨幂被拍到腹部隆起，又称将停工3个月，疑似怀二胎？	杨幂表示春节停工陪女儿, 这次离婚谣言不攻自破	unrelated
曾和霍建华交往过？杨紫首次正面回应！网友：直接率真，长大了！	网传霍建华出轨杨紫并怀孕，杨紫是这样说的，不知林心如什么感受	unrelated
腰间盘突出一些葱胡子轻松解决，5天去根不复发，腰腿疼也有效	胡子像大师清华美院辟谣：抖音上“射墨”的邵岩与我们无关	unrelated
罗志祥六千万买婚房准备结婚，网友直言：真有钱	罗志祥要结婚了？豪掷6000万购婚房，婚期定在女友生日	agreed
百白何不惧众人眼光，携外国男友高调复出，穿着时尚更大胆	白百何携男友高调复出，穿着大胆，男友颜值担当？看陈羽凡怎么说	agreed
吃大盘鸡、啃泡椒凤爪、穿羽绒服……容易感染禽流感？	「辟谣」禽流感，最近鸡鸭都不能吃？专家这样说	unrelated
67岁王石与小30岁女友田朴珺情断分手？田朴珺：实在找不	王石陷感情危机！田朴珺两次发文暗示分手，网友：比翁帆聪明多了	unrelated
喝醋可软化血管 你相信吗？	喝醋软化血管、芹菜降压、南瓜降糖？误导了你好多年	unrelated
日本网友爆出：旅行青蛙会死在途中，更可怕的是有可能被吃掉！	蛙爸蛙妈们长点心吧！旅行青蛙竟然会死！	unrelated
攀枝花学院留学生强奸女生	刀郎走的当晚，女徒云朵一首歌，于文华哭了，那英哭了，谁听谁哭	unrelated
网传河池一女子在幼儿园拐卖小孩？误会！	有人贩子进村抓小孩？娄底警方：是乌龙，不造谣，不传谣	unrelated
微信这个功能可以免费上网，手机只需这样设置下，很多人不知道	微信这个新功能可以让你家WiFi增强10倍信号，上网不卡顿	unrelated
双色球第059期头奖出号有规律 单挑一注冲击1000万	作为不可再生资源的古钱币如何才能出手？	unrelated
红枣跟它一起吃等于吃毒药，赶快告诉身边人，一定要注意！	这具干尸死了几千年 在喝下这碗符水后就神奇复活了！	unrelated
王大陆姜汉娜梵蒂冈同游被偶遇 亲密自拍恋情再添实锤	王大陆姜汉娜恋情曝光疑同居 王大陆姜汉娜恋爱过程揭秘	unrelated
洋葱禁忌和这些食物搭配吃，很可能会患结石，甚至还会引发失明！	洋葱千万不能跟它一起来吃，容易导致各种结石，甚至会引起失明！	agreed
夏天蚊子最怕这种植物！家里摆两盆，蚊子不敢进屋，美观实用	夏天蚊子最怕这种植物！家里摆两盆，蚊子不敢进屋，还净化空气	agreed
网传抚顺三道街发生火情、腾飞文具店着火了系谣言	网传洛江仙公山缆车着火系谣言	unrelated
沙湾有人吃羊肉得了SK6病毒？切！我还SK2呢！	辟谣！四川暴雨与石犀移位无关！这10个谣言不能信！	unrelated
宋小宝在饭店骗吃骗喝，连赵本山都服气！	宋小宝在饭店骗吃骗喝，连赵本山都服气	agreed
手机用久了越来越卡，不要着急修，一招教你清理手机内存	手机用久了太卡顿？教你一招旧机3秒变新机，速度非常流畅！	agreed
曹艳两岁女儿在济宁大润发被拐？谣言！	网传扫码就送“大润发”购物券系谣言	unrelated
杨钰莹要结婚了，被曝近期完婚，新郎是他！	特大喜讯！杨钰莹要结婚了，新郎竟然是他！	agreed
女人毛孔粗大真难看，一分钱不花的水果皮，缩小毛孔皮肤更白嫩！	不愿做皮肤粗糙的“老爷爷，奶奶”细化脸部毛孔的方法赶快学起来	unrelated
终于扛不住压力了，卢本伟正式道歉，网友：为啥不承认开挂！	UU终于出招，马飞飞被开除，五五开绿帽谣言不攻自破？	unrelated
70岁老人供孙子考上复旦，14年后去世儿子意外复活！	儿子去世儿媳失踪，老人抚养孙子14年的真相竟是儿子还活着	agreed
《我们相爱吧》第四季即将开播，郑爽赵丽颖CP令人期待	《我们相爱吧4》阵容强大！赵丽颖郑爽被邀请，搭档的是他们！	agreed
传C罗通牒皇马：给我梅西一样的薪水！瓜帅欲购曼联目标中场！	西媒称伊卡尔迪接受皇马体检？经纪人辟谣：假新闻	unrelated
古墓里没有氧气 为何长明灯还能千年不灭？原因其实很简单	中国古代6大未解之谜，古墓长明灯不熄，青铜剑千年不锈！	agreed
又到“草莓谣言”频发时，这些谣言不要信~	专家辟谣:Hadoop在短期内不会被Spark取代！	unrelated
不安全吗？揭秘真实的反季节蔬菜	反季节蔬菜营养差，还有害？谣言！	unrelated
佟丽娅真要和陈思诚离婚，北爱变悲哀？他是这样保鲜婚姻的	小贝出轨致离婚？发言人辟谣：无稽之谈	unrelated
喝酒脸红不易醉？万万想不到，原来这样喝酒很伤身	孩子一生1次的大脑发育高峰期，错过之后就真的难以弥补	unrelated
株洲一女士发烧咳嗽老不好 这种症状竟是患上白血病	年年都有个“刘女士”死于泡脚？媒体：又是造谣	unrelated
50岁夫妻吃这种菜一个月，肾部年轻了20岁，男女通用啊	【关于香菜的谣言】首先香菜不会杀精，作为	unrelated
杨幂高调回应离婚，一切好似尘埃落定！看看就知道了	最新消息：这4类财产属于个人财产，离婚不再分割！	unrelated
变性大咖金星离婚了！	金星自爆与汉斯离婚，结婚多年从未正常生活。	unrelated
范冰冰被邀请上《吐糟》竟耍大牌要换掉张绍刚主持人，全场都惊呆	汤姆当上明星才2个助理，再耍大牌也没范冰冰大牌！	unrelated
天气热不想吃大鱼大肉，送您杏鲍菇菜谱大全，比肉好吃的素菜	偶然搭配做出的一道菜，口感却出乎意料的好，全家抢着吃个底朝天	unrelated
皱纹再多也不用去美容院解决啦，一个开塞露小妙招，用完 就淡	开塞露去皱纹到底是不是真的，看看这个就知道了	agreed
印度女子产下十一胞胎 没见过这么多的胎儿吧！	印度一女子产下“美人鱼宝宝” 不幸的是小孩子仅存活15分钟	agreed
它们是脂肪的“克星”，每天饭后喝一杯，可以消除小肚腩！	它们是脂肪“头号克星”，每天坚持喝一杯，体重悄悄降下去	agreed
中国申办2030世界杯？足协回应	西班牙首相辟谣：报道不实，并未收到FIFA信件	unrelated
中医减肥小窍门，这三物煮水喝，20天轻松瘦18斤，速效不伤身	中医减肥补贴法，来自神奇的秘方，一个月减十斤不是梦	agreed
好消息！独生子女6大补贴累计近万元，二胎也有份	网传周迅离婚？这几个细节说明对她没有影响！	unrelated
五月份减肥吃水果就吃这几样，看看有你最喜欢吃的吗	王宝强被传新恋情，高挑女子对王宝强子女亲密无间，比马蓉强多了	unrelated
找到白发变黑发的方法可！淘米水加它洗头，白发3天变黑发	郑爽十七岁初恋曝光，这颜值有点……	unrelated
张一山恋情疑曝光，女友是澳洲出生的中英混血！恩爱互动遭实锤	YG辟谣：YG练习生确定出演综艺节目是谣言	unrelated
可口乐可不服百事蓝可乐！来一发吸脂可乐！	风靡岛国の神奇“吸脂可乐”，喝着喝着就瘦了！	unrelated
来宾街上有人发精美钥匙扣那是追踪器	精美钥匙扣内有跟踪器？谣言！	unrelated
日照一超市售卖的肉松面包内的肉松是棉花	「真相」棉花肉松是谣言，不可信！	disagreed
农村有独生子女的家庭有福利了，补贴有很多种（不可错过）	农村独生子女家庭专项补贴：每年可以领取千元以上~	agreed
怎么看待赵丽颖被迪奥解约？真的是因为英语吗？还是“气质”不符	2018年赵丽颖四部剧开播，但却遭迪奥弃用，德芙代言被抢！	unrelated
新闻联播康辉搭档谢娜主持，康辉被谢娜闹得笑称：无法沟通	康辉还原主持争议 曾因这事传出谢娜被开除的谣言	unrelated
小学全部划片入学，高价学区房白买了？	多校划片后，学区房白买了？2017义务教育招生入学工作新通知	agreed
止痛药芬必得会导致痴呆	董洁喊话，潘粤明4字回应让人落泪！	unrelated
红枣和虾皮一起吃会中毒！有科学依据吗？	辟谣 “食物相克”传言都站不住脚	unrelated
周星驰《功夫2》开拍？吴孟达、张敏回归……男主角却不是周星驰	周星驰《功夫2》即将开拍，吴孟达张敏参演，网友热泪盈眶！	agreed
美味也危险？“蕨菜致癌”尚未定论	网传蕨菜100%致癌？专家辟谣	unrelated
中国最牛的十大高校，它们的王牌专业你知道吗？	2018年志愿填报必备：全国重点高校王牌专业汇总	unrelated
余光中家属发声明：《写给未来的你》作者并非余老	广州女作家辟谣：爆红散文作者不是余光中，是她27年前旧作	unrelated
范冰冰婚后竟要退出娱乐圈 一年赚2亿备好天价嫁妆	上港2亿天价买张琳芃？高层辟谣：炒作很无聊 我们很无奈	unrelated
中央美院给予葛宇路记过处分，因为私设路牌	贾乃亮爱的如此卑微，李小璐真的会被原谅吗？	unrelated
2018年央视春晚，刘谦时隔7年强势回归，满心期待啊！	刘谦回归登湖南卫视春晚，湖南卫视会让谁来当“董卿”?	unrelated
农村宅基地确权政策：以下这几种情况，子女将不可再继承宅基地！	土地确权后，这3种情况下的子女不再具备继承宅基地的条件！	agreed
减肥期间多吃这八种水果干，轻松吸脂排毒 让你躺着也能瘦	台媒惊爆：王宝强新恋情！斩断偷腥妻同居超高䠷正妹	unrelated
没考驾照的西安人真要哭了！4月1日起，又有新规将实施！	4月1日起驾考大变？交委辟谣	disagreed
北斗地图APP上线，大家会用吗？	北斗科学家现身悟空辟谣！北斗地图和北斗导航系统没有直接关系	unrelated
低价版苹果 iPhone X 曝光买吗	一碗米线=一个塑料袋？！用小锅米线和凉拌米线实力辟谣！	unrelated
iPhone8设计全曝光，不再坑！	iPhone8钢化膜泄露：再次被确认！这才是苹果的真正水平！	agreed
婆婆为了孩子更聪明，不让儿媳剖腹产，导致羊水流干	顺产后怕遭老公嫌弃？都是谣言！我们对顺产的误解竟有这么深	unrelated
传滴滴收购ofo谈判重启 六月将宣布消息	摩拜单车火爆，被造谣高层腐败，摩拜说已经报案	unrelated
孙俪在机场发脾气，邓超在旁边不敢言，孙俪家庭地位真高	孙俪被爆“耍大牌”，与邓超家庭地位悬殊，经纪人紧急辟谣：虚构	disagreed
曾志伟曾这样回应蓝洁瑛性侵事件！现在听来特别讽刺！	曾志伟回应蓝洁瑛事件：假的，造谣，不要传播！	disagreed
38岁的陈乔恩要结婚了，不是王凯古天乐，新郎是36岁的他	网传王凯陈乔恩恋情为炒作，疑似李冰冰任泉已结婚生子？	unrelated
牙膏巧加维生素E，每天一抹，斑点皱纹消散，皮肤白嫩光滑	孕育 以下五个方面导致不孕不育发病率居高不下，你有吗	unrelated
很少有人知道它是“纯天然胰岛素”，每天喝几口，可治疗糖尿病	纯天然的“胰岛素”，糖尿病人每天喝水泡点，越喝血糖越稳	agreed
杨洋继鹿晗之后公布恋情，不是郑爽也不是李沁，居然是她	郑爽将公布新恋情？网友：比胡彦斌张翰强多了！祝幸福	unrelated
农村这3类人该睡不着觉了，国家一旦出手严查，他们必将受到严惩	王丽坤恋乔振宇8年却被劈腿，离开他后大红大紫	unrelated
套路升级！章子怡点评反被怼，张国立5个字打脸《演员的诞生》	《最美表演》打脸《演员的诞生》，10位演员为真正的演员正名！	unrelated
揭秘：内分泌失调引起长痘，要怎么调理	内分泌失调长痘怎么办 调节内分泌是关键	agreed
每天几勺醋泡葡萄干，排毒还养胃，轻松瘦身不反弹	花生这样泡一泡，减肥瘦身又健康，轻松瘦下来健康不反弹	unrelated
木筷子半年不换会致癌？难以相信筷子的发明者竟然是苏妲己	日本人大量使用中国木材做筷子？别再被这些谣言误导了！	unrelated
“刘恺威出轨王鸥”最新资讯	从刘恺威出轨事件，看王鸥的成名记！	agreed
早晨吃姜有3大奇效 为何晚上吃毒似砒霜？	晚上吃姜等于吃砒霜？	agreed
癌症等于绝症	得了癌症就等于被判死刑？医生说实话：这5种癌并非绝症	unrelated
两个多月暴瘦40斤，不节食不反弹，懒人方法	最适合懒女人的瘦身妙招，不运动不节食，一周瘦六斤就够了！	agreed
卢本伟粉丝聚会骂人引众怒，粉丝认怂发道歉视频，承认卢本伟开挂	卢本伟出现在某音是谣言？uu出面澄清，蹭热度背后的利益问题	unrelated
生男生女？看这3个地方就够了！	民间偏方虎耳草治痔疮，操作简单易懂，最低一周就能治愈痔疮	unrelated
烟王褚时健去世	辟谣：一代烟王褚时健安好！	disagreed
2018蚂蚁花呗怎么套现 取现怎么安全放心	有个体商户营业执照的！进来教你们花呗套现	agreed
曾跪下为孙红雷求戏，命运惨4次堕胎被抛弃，现狼狈沧桑成这样	曾饱受被“包养3年”“堕胎4次”谣言，活成了女人最想要的样子	unrelated
好消息！每户补贴18万，国家要统一规划农村房屋了！	宋祖德称王菲和谢霆锋已分手，如果有假他将吃狗屎，网友乐了！	unrelated
永靖县四局职工医院输液一针打死人	高血糖怎么办？每天一杯野生绿萝花茶 每天喝一杯降血压有奇效	unrelated
汕头6月实施驾考新规？广东省交管局称消息不实	3月谣言盘点：海绵八宝粥、驾考新规，你中“谣”了吗？	unrelated
脖子粗的人易患心脏病，赶紧量一下，看你超标了没有？	谣言：颈动脉有斑块要尽快手术	unrelated
二胎如愿生下男宝宝，儿女双全啦，数数这些症状和数据，接儿子啦	全男宝症状生了小公主，顺转剖！分享下经历，小棉袄谁接？	unrelated
卫生组织鉴定：全身致癌的3种蔬菜，赶快告诉家里人	生活中常见3大“致癌”蔬菜，第三个尽早戒掉，最后一个你天天吃	agreed
南昌高楼大火，多人梦中被火化？视频中分明听到说外语	丹阳一餐馆发生火灾 男子造谣49人死亡被拘3天还写检查	unrelated
楼市又一重磅！仅隔44天，这个地方为啥限购再升级？	甘井子限购出辟谣啦，这次是是真的还是假的？	unrelated
常做B超是否影响胎儿发育？孕期做B超不能太任性	孕期睡姿选不对，会对胎儿的发育造成影响，孕妈别不以为然	unrelated
吃这4种食物等于自杀，其中一种你有没有经常吃！	营养学副教授辟谣：并非所有腌菜都致癌，注意1件事再吃，不用怕	unrelated
《战狼2》很燃?看下真正的中国撤侨,祖国原来这么霸气!	外国人回国最想从中国带走什么？印度女生的选择让人意外！	unrelated
母乳影响新生儿黄疸？如何治疗及预防	母乳喂养导致黄疸严重！新生儿喂养十大“忌”!	agreed
张翰高调宣布恋情，又一女神被俘虏，求求你别祸害她	张翰高调宣布恋情，又一女神被俘虏，网友：求求你别祸害她	agreed
太仓不绑定备案就不能处理非本人名下车辆违章	北京交警辟谣：3月1日起不绑定备案就不能处理违法系误读	unrelated
它除了能做调味品，还能杀菌抗癌、降血糖，好多治病小妙方都用它	糖尿病人做好这点，血糖降到6.0，慈祥的老大妈控糖有方法！	unrelated
打电话不想接，又不好意思挂断？教你一招，手机轻松变空号！	手机来电不想接，又不好意思挂断，教你打开这个功能，手机变空号	unrelated
张柏芝与小十岁鲜肉男星大婚，你信吗？	“资金黑洞”流言散播！伟信公司报案并发声明：系网络谣言！	unrelated
夏天必吃的一种菜，防癌，排毒养颜，减肥，功效多，而且还便宜	女人不想胖？香蕉这样吃，排毒养颜、减肥的同时还能治痔疮	unrelated
温州全市停水	“我市15日晚全市封城”消息系谣言	unrelated
纯天然胰岛素，号称糖尿病“死对头”，连喝三个月糖尿病不攻自破	纯天然的“胰岛素”，糖尿病人每天喝水泡点，越喝血糖越稳	agreed
美专家称打败俄罗斯最快仅需10天时间	美军事专家称10天打败俄罗斯？如此狂语底气到底源于何处？	agreed
印度一女子产下“美人鱼宝宝” 不幸的是小孩子仅存活15分钟	印度女子一口气生下11胞胎，网友可以组成足球队！	unrelated
想知道WIFI密码？根本不用下载软件，教你一招轻松破解！	破解WiFi密码，让农场主抓到了	unrelated
温婉发现赚钱“新套路”赚疯了，网友：你这是要火	已生两胎女儿，三胎意外怀孕生下男宝来，附孕期症状，传大家好孕	unrelated
杠上了！恒大5000万欧报价纳因戈兰 国安也同样价格参与争夺	迪马济奥辟谣恒大报价罗马中场：双方并未接触	disagreed
琼瑶江郎才尽了吗？又要翻拍《情深深雨蒙蒙》，新演员有人看吗？	《情深深雨蒙蒙》将翻拍，演员大换血，只有她没被换！	agreed
开塞露这样用，皮肤水嫩白净，48岁保养的像20岁	开塞露擦脸竟然可以水嫩护肤，睡前保养几分钟，皮肤白净又水嫩	agreed
月经量少预示卵巢早衰？多吃它，补充雌激素，卵巢毒素一扫而光	女性月经量少是早衰的信号，每天吃点它，呵护身体防早衰	agreed
清河广场出车祸、伤者找不到家人	驾驶证替人销分出新规、代扣分小心罚款且拉黑	unrelated
刘嘉玲大方回应：梁朝伟要当爸爸了，梁朝伟：有种说不出的喜悦！	梁朝伟当爸爸	agreed
世界上唯一一个没有癌症的国家 只因这里的居民常吃这种食物	全世界唯一没有癌症的国家，胖子的天堂，因为他们常吃这种食物	agreed
杨幂是否有了二胎？传闻说有了？	都不知道的小秘密，洗头加点它，3天头发乌黑茂密，头皮屑也没了	unrelated
白酒和它一起泡，颈椎、腰椎、膝盖关节痛全好了	终于要结婚了！陈乔恩宣布婚讯，新郎不是王凯，缘来是他！	unrelated
《歌手》总导演洪涛被曝离职湖南卫视 申请已获批	洪涛将离职湖南卫视？网曝《歌手》总导演洪涛将离职湖南卫视	unrelated
害死梅艳芳 出卖刘德华  刘嘉玲差点因她自杀 终于遭报应了	最爱的梅艳芳死在刘德华的怀里	unrelated
猜宝宝性别丨酸儿辣女、看妈妈肚子……这些方法你一定试过	【谣言粉碎机】谁说怀孕了一定要多吃才能保证营养？	unrelated
管不住嘴怎么减肥？教你做碗好喝的瘦身汤，体重迅速往下掉	杨钰莹都45岁了，为什么还不结婚？	unrelated
白茶是糖尿病的克星	王菲带女儿李嫣整容3次，亭亭玉立颜值上线，李嫣：我终于不丑了	unrelated
游客打赢棕熊，麻醉枪放倒熊孩子	游客打赢棕熊,麻醉枪放倒熊孩子	agreed
吴青峰帮唱张韶涵	人皇SKY澄清：自己并非张韶涵男朋友	unrelated
混改有望接力债转股，这几只有望诞生新妖股！	联通澄清混改传闻：与潜在投资者谈判尚在进行	unrelated
无良记者！扬言球迷的空场抵制很丢人 让中国足协向亚足联道歉？	中国球迷空场抵制亚洲杯，韩国球迷给出了回应	unrelated
好白菜都让猪给拱啦！女子与一头猪同床共枕秀恩爱	女子与猪同床5年，声称彼此是相爱的 网友：好白菜都被猪拱了	agreed
刘德华已同意参加《爸爸去哪儿》，欲征询家人意见！	听说刘德华受邀参加《爸爸去哪儿》，你期待吗？	agreed
农村老奶奶治疗脚气偏方，3天根治10年脚气不复发	用啤酒这样洗发，白发再嚣张，8分钟头发乌润如墨，告别染发	unrelated
瓜帅发声，梅西真要去曼城？逼宫高层，巴萨动荡何时结束	世体：巴萨辟谣支付格子违约金	unrelated
继冯提莫干爹床照曝光后，陈一发回应离婚事件！	冯提莫停播23天后回归，重回斗鱼一姐，正面回应离婚谣言，不虚	unrelated
章子怡新剧搭胡歌？国际章为什么回归小屏幕和赵丽颖孙俪抢收视？	胡歌新剧又要来霸屏？与赵丽颖马思纯搭戏简直无可挑剔！	unrelated
女生独行遭流浪狗撕咬，走路遇到恶狗该如何自救？	女生遭流浪狗撕咬！动保协会跑哪去了？	unrelated
农村，以下7种农房要保不住了，老家有房的看看吧！	农村这7种农房基本保不住了，有以下几种房屋的要早做准备了！	agreed
剧情反转：马蓉一家声讨宋喆，曝聊天记录开撕 网友：太精彩！	网曝疑似马蓉宋喆聊天记录曝光	unrelated
娱乐圈的李小璐和贾乃亮将要离婚，网友王宝强说，又多了一位兄弟	刘强东辟谣永远不会开除任何一位兄弟，网友：被开除的都不是兄弟	unrelated
6分钟头发乌黑告别染发，不管白发多疯狂，用橘皮这样洗就OK了	董卿怀孕暂退出央视唱的一首歌，撒贝宁和富豪老公重头哭到尾	unrelated
古墓里没有氧气 为何长明灯还能千年不灭？原因其实很简单	古墓里的“长明灯”真的会千年不熄吗？	agreed
学会这个减肥技能，一个月瘦15斤不是问题！	减肥早餐，一个月瘦20斤这么吃	unrelated
美国苏联停止登月的背后，真的是在月球发现了外星人基地吗	月球背面真有外星人基地 嫦娥二号拍到了什么 这张照片轰动世界	unrelated
得了高血压注定与肉无缘了？这种醋经常吃，还能软化血管！	最近曝出王宝强与马蓉将复婚	unrelated
“蒸食物一不小心就致癌”,朋友圈疯传的信息有道理吗？	自来水煮东西易得癌？水务集团辟谣：放心使用	unrelated
景甜急着带张继科见家长，似在商讨今年结婚？	景甜被爆与张继科已登记，网友祝福，景甜方9个字实力辟谣	disagreed
任静付笛生近照，双双皈依佛门，儿子帅气酷似老爸，音乐天赋极高	任静付笛生近照，网曝两人双双患癌皈依佛门，如今生活令人唏嘘！	agreed
王思聪生气了，秦奋不服了，PGone亏了，没想到Gai要火了	秦奋再曝猛料 1400万公关费是贾乃亮所出	unrelated
又一央视一姐癌症复发，脸部变形判若两人 被迫离开舞台让人心疼	又一央视主持人癌症复发脸部变形，被迫离开舞台，网友心疼不已	agreed
脸上有痘痘和痘印怎么办？教你一招，美白祛痘印还抑制黑色素	马云：未来三年，我要收购京东，刘强东：你可以试试	unrelated
王学兵吸毒 曾是范冰冰前男友的他走上了一条不归路	比范冰冰美的妲己，经历两次婚姻失败，52岁因吸毒被拘留	unrelated
王宝强新恋情曝光，走出马蓉宋喆阴影，疑牵手熊乃瑾？	熊乃瑾发文疑似和王宝强公开恋情	agreed
微信转发这种视频会感染病毒泄露隐私？网警的查证结果来了	对转发次数有要求？爱心筹官方辟谣：假的！	unrelated
东太行景区关于玻璃栈道的致歉信	东太行玻璃栈道碎了 哎呀哎呀哎呀呀呀吓死我啦	agreed
宋丹丹公开怒斥儿媳：这四个原因，使得宋丹丹对儿媳妇极为不满！	宋丹丹大骂自己的儿媳妇：大烟鬼，离我儿子巴图远点！	agreed
广西13人吃西瓜感染病毒死亡	商丘一男子造谣“13人感染N7N9病毒死亡”被拘留10日	unrelated
吃酱油皮肤会变黑吗？	扎耳朵治中风，伤口不能吃酱油……这十大健康谣言你传递了几次？	unrelated
网传上海青浦朱家角发生命案，一个女的被捅了	网传新版人民币视频实为谣言，希望大家不信谣，不传谣	unrelated
二战德国党卫军和国防军有什么区别，为什么可以枪毙党卫军俘虏	打破纳粹国防军军纪严明的谣言，这一支部队罪行铁证如山	unrelated
张一山恋情被曝光，不是杨紫，不是周冬雨，原来是她！	张一山恋情疑似曝光，女友曾参演《一年级》，还是中英混血	agreed
农村自建房补贴标准出台，来看一看你家的自建房能补贴多少钱？	明年起国家将不允许农村自建房了？是谣言？还是事实？	unrelated
意外！张翰、娜扎今日宣布结束恋人关系！分手原因万万没想到	娜扎公开宣布“新恋情”，网友隔空喊话张翰：确实比你帅！	unrelated
永春：“楚安小学附近有人贩子在活动”是谣言	“实验小学学生家长”又捡到钱包了 警方提醒：勿轻信转发谣言	unrelated
王思聪前女友雪梨怀孕12周，孕吐严重不忘工作，难怪能年入十亿	王思聪前女友雪梨怀孕，被网友质疑孩子是思聪的~网友评论亮了！	agreed
于文华要走！朱之文含泪一首《沂蒙山小调》让于文华现场听哭！	于文华带朱之文回家乡，在村口给妈妈唱了一首歌，全村人哭成一片	unrelated
火药味十足，崔永元曝范冰冰天价合同实指国内行业畸形片酬	4天六千万！崔永元疑开炮范冰冰天价片酬	unrelated
塑料大米、塑料紫菜、塑料粉丝……是时候击破这些“塑料神话”了	紫菜、粉丝是塑料制成？八大健康谣言出炉，转到亲友群！别上当！	unrelated
井柏然倪妮再秀恩爱，合约情侣的捆绑价值	井柏然被拍到与倪妮逛商场 网友猜测二人只是合约情侣	unrelated
于文华离婚那天差点自杀！节目用这歌揭秘于文华看上朱之文的原因	出名就要闹离婚？大衣哥朱之文实在有苦难言！	unrelated
于文华讲述认识大衣哥朱之文过程，全靠老公大力推荐	大衣哥朱之文一首《滚滚长江东逝水》而成名，于文华决定嫁给他	unrelated
中学生被挖心脏尸体吊树上	ETC如此方便，那为何有70%的车主不办？真相让人大跌眼镜	unrelated
哈士奇为报恩女主，竟把男主的私房钱全找出！	哈士奇为报恩女主，竟把男主的私房钱全部找出，男主哭着跪搓衣板	agreed
使任何触碰到湖水的動物瞬间石化的“石化湖	"石化湖""""可以使任何触碰到湖水的动物瞬间石化"	agreed
王菲、李亚鹏复合有望，那谢霆锋怎么办	锋芝恋有望复合，王菲心情难过难掩饰	unrelated
外卖小哥凌晨痛哭：有些人只是活着，就拼劲了全力	外卖小哥有多苦 因差评竟痛哭，每个职业岗位都不简单！	agreed
农村人爱吃的一种菜，竟是癌细胞的“克星”，能降三高还健脾益胃	过了25的女人，少穿高跟鞋，最好穿平底鞋，提气质又显可爱	unrelated
农民工注意：明年农村低保待遇将提高，但5种人不能继续吃了！	农村低保标准上调，这几类人将无缘享受国家低保补贴	agreed
如何评价这次冯提莫强行绑王思聪，不惜涉黄造谣诽谤？	斗鱼官方说“造谣”，“拖欠门”摇身一变成为“罗生门”	unrelated
每天吃鸡肉高血压风险降四成	高血压患者的福音不用吃药轻松降压永远断根快告诉父母	unrelated
姚明2.0版，周琦正式加盟火箭！他或成为火箭的第三巨头	“周琦加入火箭”是假消息，让我们来还原背后的真相	unrelated
生姜跟它一起洗头，3天白头发快速变黑，不学可惜了的黑发技巧！	白发不用染，洗头用这个东西抹一下，3天抹出浓密黑发，值得收藏	unrelated
江西多地又出现偷抢小孩事件？是真是假？	辟谣：“巩留女孩山区被拐”是假消息 警方：女孩落水多日未找见	unrelated
养生：晚上吃姜毒过砒霜 六类食物晚餐时别碰	晚上吃姜毒过砒霜，有科学根据么？	unrelated
早晨洗脸水中加点”料“六十岁不长斑、不长皱纹不显老！	民间一土方，因长得丑无人问津！但祛斑美白淡皱纹不在话下	unrelated
潘玮柏大方承认恋爱，是与吴昕假戏真做了吗？	吴昕自从和潘玮柏恋爱之后会唱歌了，和快乐家族合唱《勇气》好听	unrelated
百元人民币上印有“跪拜猫”	百元人民币正面惊现“跪拜猫”	agreed
燕郊房价暴跌却无人问津，炒房客的春天怕是要结束了！	燕郊房价暴跌2/3 现在是最佳的购买时机吗？	agreed
林允晒照双腿全是淤青，网友：像是被家暴了	林允晒照双腿淤青，网友：不会是家暴吧	agreed
光伏发电是骗局	光伏发电项目恐成大骗局！也许从一开始就是骗局！	agreed
包头土右旗民生渠以北已被淹没，村民们都往南撤	章子怡犀利评价袁立演技，宁静 陈佩斯的评论更是一针见血	unrelated
小儿咳嗽秘方，妈妈煮了这碗水，喝了它，2天根除不复发！	白糖蒸鸡蛋能毒死人，鸡蛋和白糖可以同吃吗？谣言？	unrelated
主持人问首富王健林：对儿媳妇有什么基本要求，首富回答亮了 7	主持人问首富王健林：对儿媳妇有什么基本要求，首富回答亮了	agreed
最新消息：华为借壳中字头第一龙头股上市获批，超顺丰控股8连板	李大霄发文：华为借壳环保第一龙头上市获批，将超顺丰控股九连板	agreed
王欣归来即将东山再起，快播下一站：游戏和区块链	快播团队将推“区块链+视频”产品	unrelated
男童爱喝饮料，喉咙长满鹅卵石！大人小孩夏天都别再这样喝饮料了	痛心，男童爱喝饮料 咳嗽检查发现喉咙布满“鹅卵石”	agreed
“史上最冷春节”卷土重来！	注意！“史上最冷春节”是谣言	unrelated
梁永涛、张慧又丢火车票了？仍是恶作剧玩笑，鉴定完毕！	微信官方 都被纷纷辟谣了，还有小伙伴在朋友圈求圣诞帽	unrelated
关之琳高调复出待遇却差林青霞十条街，网友：高尔夫一生黑？	关之琳自愿被塞高尔夫球真相 豪放起来不要命	unrelated
全省下周将出现1992年以来最寒冷天气，惠东还将下雪？	山西气象局权威发布 未来无雪 只剩晴冷不要再听信谣言啦	unrelated
农村养老保险一次性补缴15年，60岁后每月可领1300元吗？	2018年农村养老保险有变，一次性补缴15年的政策要取消？	unrelated
张柏芝决定参加谢霆锋婚礼，为儿子愿一生单身祝王菲，新婚快乐	张柏芝决定参加谢霆锋婚礼，为了儿子愿一生单身，祝新婚快乐	agreed
江苏昆山一店铺发生倒塌事故 未发现伤亡人员	23点30分有余震？廊坊市政府新闻办官方微博辟谣	unrelated
微信被拉黑了，这个方法可以强制聊天，看完我就学会了，太实用	逆天了！微信被好友删除拉黑，一样可以聊天！方法还这么简单！	agreed
台湾餐厅供应烤婴儿	医生警告:经常吃这三大类食物 癌细胞会在身体内疯长	unrelated
房产证下岗不动产权证登场 芜湖市先行步入不动产统一登记时代	房产证下岗不动产证入职 济南这49个楼盘业主自己就能办证	unrelated
第四套人民币退市 80版5元身价大涨快快收藏！	为何霍建华会娶林心如？霍妈妈不小心说漏嘴，原因让人意想不到	unrelated
真相大揭秘~澳大利亚对中国护照免签了？	吾爱辟谣｜“外交部推常旅护照141国家白本免签”是假消息	unrelated
林志玲小腹微隆、身体变胖。网友疑似怀孕	林志玲发文，辟谣“怀孕”传言	disagreed
买房万万不要考虑这一层，入住才知道有多“坑”！有人吃过大亏了	一栋楼不管有多少层，买房切记要选这几层楼，有钱人一看就懂了！	unrelated
中国第一狗仔曝张继科袁姗姗恋情，结果评论区被网友狂喷	冰壶运动员工资只有1600？关于冰壶的谣言你信了几个？	unrelated
手机输入4个数字，WiFi立马提升一倍，比换路由器都管用！	手机输入4个数字，WiFi瞬间提速，10G视频瞬间下载完成！	agreed
茄子不能和什么一起吃 这样吃茄子危害翻倍	提醒：茄子不能和它们一起吃，不然后果很严重！快告诉身边的人	agreed
经常用电脑的你怎么能少了这几款植物呢？防辐射的小能手	辟谣特工队｜仙人掌可以防电脑辐射？不存在的	unrelated
房产证下岗，对谁影响最大？和你买房有关系么？	汕头5月1日后房产限购限贷？纯属谣言！	unrelated
紧急扩散！手机勒索病毒来了！	"[辟谣平台]""扎针放血""救中暑?专家:需专业人士施行"	unrelated
房祖名暗中相助成龙私生女，传1300万帮买豪宅还给钱花	成龙闭口不谈私生女，儿子房祖名却与妹妹十分亲近	agreed
张一山相恋七年女友曝光，张一山深藏不露，连杨紫都不知晓	张一山大方承认恋情，女友疑似大学同窗白雪！	agreed
成都市民通宵排队买雄飞生活广场的房子	员工拍抖音造谣成都通宵排队买房，房产中介遭处罚	unrelated
年龄划分新标准，你是在青年还是中年？	最新年龄划分标准出台，对照过后惊呆了！	agreed
宁波整顿“共享单车”！即日起暂停投放！	辟谣丨公共自行车租赁服务将取消？城环公司这样回复……	unrelated
女子与猪同床4年，牛B！	女子养了一头170斤的宠物猪，同床五年还和猪一起玩亲亲！	agreed
手机刚好拍到重庆蔡家出现的海市蜃楼！真清晰！	昨日北碚上空现海市蜃楼 像一座天空之城	agreed
王思聪生气了，秦奋不服了，PGone亏了，没想到Gai要火了	秦奋再爆pg one 猛料，连冠军都是贾乃亮“给”的！	unrelated
减肥控制不住食欲，中医教你一招，每天一碗，轻瘦肚子	减肥减肚子的首选方法 一招就能疯狂瘦	unrelated
刚刚！河南第一个2018年限行城市公布！焦作限行还会远吗？！	紧急辟谣：银川2018年限行政策出炉？事情的真相是这样……	unrelated
农村这2个证即将停办，价值20万，农民朋友抓紧办，错过吃大亏	农民这2个证能换20万，有的话就发财了，快看看你办了吗？	agreed
乙肝会通过公共餐具传播	这样洗脸，60岁都不会长皱纹，而且不花钱！快来学一学吧！	unrelated
江西潘阳发生驾车恶性撞人事件 致3死11伤	玉溪极中心恶性案件是谣言      	unrelated
微信朋友圈也能看访客记录了，快来看看谁在关注你！	天呐，微信居然可以查看访客记录？！	agreed
20條飲食規則幫助你打造肌肉身材	多吃蛋白质就能长肌肉？	unrelated
刘涛已和王珂离婚，恋上小八岁的他？网友：不可能	刘涛也有“黑历史”八年前与50岁前夫离婚，闪婚王珂	unrelated
男子听信朋友圈“保命指南”，服下“万能药”阿司匹林险被夺命！	疯传的“心脏病急救”会要命，阻止谣言就是在救人！	unrelated
交警提示：车主别中招！高速过站拿卡直接扣2分还得罚200块！	交警提示：车主别中招！高速过站拿卡直接扣2分还得罚200块	agreed
李宇春跟老外结婚	李宇春被传嫁给78岁老外？春爸被逼亲自辟谣：假的！	disagreed
乔治·维阿当选总统 利比里亚将开启全新征程	千里走单骑！“总统先生”米兰时期最佳进球	unrelated
苹果手机价格暴跌，谁是“幕后真凶”	iPhone8逆天功能已确定，三星S8价格太猛苹果7售价暴跌	unrelated
生姜加它一起吃，1天暴瘦了25斤，告别大肚腩，拥有小蛮腰	一片生姜水加它，1天暴瘦15斤，2天减掉水桶腰，轻松刮油去脂	agreed
杨幂停工三个月，小腹隆起疑似怀二胎？刘恺威：准备要个儿子！	《扶摇》杨幂承认用替身与抠图，原因是自己已怀有二胎！	unrelated
“牡丹江二院门口杀人”？谣言！	潍坊“毒生姜”事件视频 系谣言误导消费者	unrelated
2018年春晚节目单公布，吴京演唱歌曲《风去云不回》	百度辟谣“李彦宏小三事件”，医疗竞价广告死灰复燃！	unrelated
石湾大桥即将加装交通抓拍摄像头，专门是针对这些车的	“江水上涨，禁止车辆通行”？石鼓交警中队辟谣！	unrelated
30%暴跌至2%仍“不长心”, 韩国三星，真的要“放弃”吗？	全线暴跌！三星在中国面临崩塌，市场仅剩2%！	agreed
教你如何利用手机微信，一秒定位别人位置，知道的人真不多！	教你利用微信定位，一秒知道老婆的位置，比卫星定位还准	agreed
台湾节目：地球邪恶双胞胎在西藏，布达拉宫地道里有何印记？	5年前马云演讲口出狂言：支付宝让银行睡不着觉；你只道吗、	unrelated
海门一对男女汽车内开空调干“这”事？汽车自燃被烧死？	海门两人汽车内开空调偷情，汽车自燃被烧死系谣言	disagreed
宋智孝对李善均说出轨原因，这种感觉结婚久了的女人都会有	RM：话题“金钟国若与宋智孝结婚，众成员反应亮了	unrelated
范冰冰李晨结婚了!奉子成婚排场大？	范冰冰竟承认怀孕，李晨在一旁惊呆了	unrelated
女生吃槟榔会导致不孕吗，女生吃槟榔的好处和坏处	科普！槟榔口腔癌谣言源起何处？	unrelated
女人饭后泡一包它，坚持每天2杯，燃脂又排毒，连喝一个月轻松瘦	睡前喝一杯茶，燃脂排毒一整夜，悄悄瘦下去	unrelated
梁永涛、张慧又丢火车票了？仍是恶作剧玩笑，鉴定完毕！	WOJ旗下记者辟谣：詹姆斯和沃顿一直有联系，计划很快会谈	unrelated
美国司法部调查华为，指控比中兴那次更严重！华为：莫须有！	京东方等辟谣“制裁传闻” 多公司澄清中兴通讯事件影响	unrelated
古币市场开春依旧火爆，袁大头又拍出200万高价	卓伟：王杰事件不是谢霆锋，是另有势力之人，网友：王杰别想不开	unrelated
农民缴纳养老保险不会吃亏，养老保险可以继承，农民不用担心	这些人2018年新农合医疗费不用缴纳？看看有没有你	unrelated
7月1日起，支付宝余额宝自由存取功能将受限！	支付宝辟谣：不会限制余额宝直接付款	unrelated
《楚乔传2》即将热播，宇文玥复活保护楚乔，女二竟换成演技派的	农村独生子女有3项补贴，很多人都不知道吧！	unrelated
朋友沦为仇人, 盘点娱乐圈反目成仇的明星, 最后一对竟因为…	曾经是闺蜜挚友，为何如今反目成仇的明星？看完你就知道	agreed
实拍逐渐出现的棍状UFO, 还有其它UFO飞进里面	在国外疯传的一段视频：高清实拍UFO从城市楼宇间掠过	unrelated
同样是二婚，汪涵杨乐乐世人皆知，刘涛究竟要隐瞒到什么时候！？	刘涛前夫遭曝光，隐瞒了8年终于还是瞒不住了，原来就是他！	unrelated
大众推出新款suv挑战哈弗H6,仅售价11万，你们会买谁？	锋菲婚期已定！二人深夜抵港谢贤接机，狄波拉7字表态一脸笑意！	unrelated
杨洋和郑爽结婚后，无比的甜蜜！	郑爽杨洋筹备结婚的事 周围一圈祝福	unrelated
俄第五代战机正式被命名苏-57，后年交付俄军，啥时交付印度？	俄官方视频辟谣，别再质疑苏-57无内置弹仓！	unrelated
《哼哼日记》六这些判断生男生女的方法真的准吗？一个奶爸的自述	生男生女由卧室决定，这也太不可思议了吧！	unrelated
宝鸡文化路外卖小哥被耳机线割喉	梁朝伟公开宣布：我要当爸了，但孩子不是嘉玲生的！	unrelated
天天吃的白米饭是垃圾食品之王？	「健康」惊出一身冷汗！白米饭是垃圾食品之王？快来看！	agreed
中医说正确食用鸡蛋，加上一两枸杞+10颗红枣，竟然摆脱前列腺	枸杞+红枣+鸡蛋，15天根除，7年的前列腺到现在都没犯	agreed
男婴怀了18年，终于被生了下来	朋友们这个紫菜这个牌子的不能吃是塑料袋做的？	unrelated
票房狂轰33.97亿，王宝强都赚翻了，马蓉：我对他还有感情	中国卫生巾竟然致癌!!姨妈巾又出事了含荧光致癌	unrelated
戴银戒指,戴的那里会变色,是因为在吸身体的毒素	纯银戒指佩戴一段时间后慢慢变黑，是因为吸收了身体内的毒素吗？	agreed
喝粥能养胃，“汤泡饭”却伤胃 天理何在！	喝粥能养胃，为什么“汤泡饭”偏偏就伤胃呢？	agreed
经常吃的大蒜还能治白癜风？经验来源于生活，就是这个道理！	吃好一日三餐，辅助治疗白癜风	unrelated
校外机构与海师大合作成人教育招生？辟谣：谨防上当受骗	网传湖州3考生考试后电鱼不幸身亡 相关权威部门辟谣	unrelated
上海人民广场附近发生砍人事件	「辟谣」今日网上有谣言称人民广场附近发生砍人事件	unrelated
张杰谢娜双胞胎女儿首次公开曝光，没想到这么大了，都会翻身了	谢娜双胞胎女儿全身照首曝光 都会翻身了	agreed
卓伟爆料一位影帝女明星出轨8千万买照片？卓伟：8个亿都不行！	网传邓超花8000万买出轨照，真是心疼孙俪！	unrelated
淮南人朋友圈热传“飞机撒药治白蛾？”	合肥网第e时间：美国白蛾谣言又起，市民请勿相信谣传	unrelated
“中国橙王”被传去世？ 褚时健亲自对着镜头说	辟谣！“褚时健逝世”是个假消息！原消息微博已删除！	unrelated
一家四口得癌症，难道癌症会传染？可能是吃错了这几样食物！	辟谣小议：多吃维生素真能防癌？腌制食品却易致癌？	unrelated
人类将来能否摘到“癌症”这顶帽子？	得了癌症就等于死亡，营养都给了癌细胞，关于癌症谣言你知道多少	unrelated
新塘农药残留严重，辛苦一年养出的蟹又小又黑，一家三口白干一年	农药中毒很严重，请认真看！如何清除蔬菜中残留农药的方法	unrelated
张翰公布最新恋情，女友帅气可爱有气质！郑爽娜扎还是另择良偶吧	林丹母亲陈述真相：谢杏芳原谅林丹是唯一选择 林丹才是主家的	unrelated
“毛孔粗大”屡试不爽，试试鸡蛋清加点”它“，紧致皮肤像16	多数人不知道的洗脸坏习惯，怪不得毛孔越来越大，皮肤越来越粗糙	unrelated
孙俪娘娘给邓超的“黑蒜”食补到底是什么？适合三高、癌症患者？	邓超曾追求过她，却因身患癌症离开人世，年仅36岁，令人惋惜！	unrelated
联想手机向小米宣战！联想副总裁科普什么是真正的全面屏	小米收购联想手机系谣言 行业大V：为上市托市值的幺蛾子罢了	unrelated
唐嫣罗晋公开订婚 两人都整过容 是真的吗	唐嫣罗晋公布恋情已订婚 闪婚的节奏两人情史曝光	agreed
不用每天吃降压药，控制高血压的方法	重大新闻！高血压不用再吃降压药了，非常多的人都不知道！快转发	agreed
肿瘤专家真情发声：防癌抗癌，就记住这个字！	怎么吃洋葱抗癌效果最好	unrelated
央视都播了！60岁以下逮捕罚款，今天起全国严查棋牌室？	官方辟谣：拉米雷斯非卖品 外租完全是假消息	unrelated
央视都播了！60岁以下逮捕罚款，今天起全国严查棋牌室？	网传“分尸惨案”？警方辟谣：假的！	unrelated
绵阳东原大桥断了	国产又一炮而红！“华为汽车”一步登天，价格真比手机还实惠！	unrelated
吴京：谢谢他当初的看不起 甄子丹与吴京的恩怨是怎么回事？	甄子丹微博长文首次回应与吴京恩怨，网友：那赵文卓释小龙呢	unrelated
以后不要这样吃鸡蛋了，致癌的几率高，别不当回事	鸡蛋柿子不能同吃 5种食物是“鸡蛋克星”	agreed
加微信免费领礼包	免费送加微信，免费领取	unrelated
乐视控股高层：乐视网不可能退市 理解孙宏斌	九鼎集团复牌官宣 退市谣言不攻自破	unrelated
2017年新劳动法全文规定,新劳动法辞退规定病假工资规定	2017年劳动法关于辞退员工补偿标准	agreed
白头发多？洗头加点它，4天白发变黑发，不用在染发啦	生姜加上它煮水洗头，白发慢慢变黑发，再也不用花钱染发了	unrelated
2018年农村土地政策重大转变！30万退出宅基地你愿意吗？	自愿退出宅基地一次性补偿30万，部分地区已实行，你会怎样选？	agreed
张靓颖牵手帅哥，原来是张靓颖冯轲婚礼伴郎	张靓颖被爆新恋情，新男友曾是自己婚礼的伴郎，这关系有点乱！	agreed
太可怕了！4岁女孩被外星人掠走，并产下非人类物种	4岁女孩被外星人掠走，并产下非人类物种，科学家证实是真的	agreed
考古专家研究“千年古尸”，不小心中“尸毒”，治疗数年不见好转	辟谣！菏泽青丘遗址出土珠宝瓷器不实	unrelated
刘作虎手持一加6被曝光 性能旗舰即将面世	刘作虎辟谣一加X2传闻：以后只做旗舰	unrelated
改装路由器天线增强无线信号	家里wifi信号弱？教你一招，路由器信号增强数倍	unrelated
没有硝烟的战争，转基因粮食导致不育不孕。	这6种茶是“脂肪的克星”、每天早餐后半小时喝一杯、让脂肪燃烧	unrelated
上市之后雷军又有新动作了：疑似小米汽车要雄起了？	小米否认明年上市称无时间表，此前雷军多次辟谣称仍需一两年	unrelated
有房必知：房产证将下岗 如何证明房子是我的！	房产证下岗 谣言！仍有效无需更换	unrelated
因为雾霾里存在硫酸铵才发布红色预警	发布“红警”是因为雾霾含剧毒硫酸铵?	agreed
和中国抢高铁订单，日本倒贴钱建高铁，英媒：菲律宾肯定要后悔	日本抢走中国百亿订单，不料是个巨坑！请求中国出手相救！	unrelated
戴隐形眼镜玩电脑易致人患白内障	大辟谣：看似高大上的水晶眼镜真的能明目吗？	unrelated
世界上第一对“孵化器婴儿”问世	离婚后张靓颖，真空上演，越来越大胆了！	unrelated
范冰冰李晨67.8亿存款转移美国	网友晒菜单澄清“李晨天价面馆”谣言	unrelated
花椒和它放肚脐，7天暴瘦13斤，10天甩掉肚腩，排湿毒治便秘	花椒和它贴在肚脐上，3天排湿毒治便秘，20天瘦了28斤	agreed
因老婆背景太强大而不敢拈花惹草的男星	老梁为什么都敢说？看了他老婆的背景，你就知道了	unrelated
173斤减到91斤，几味中药煮水喝，刮油排毒，减肥效果翻倍	肚子大怎么减肥？中医推荐这几物煮水喝，甩掉大肚腩	agreed
早晨起床不能做的事，你知道几件？这几个习惯堪比慢性自杀	早晨起床后的五个习惯竟是慢性自杀	unrelated
孕妈好心情 宝宝遗传快乐基因	孕妇总爱吃蛋糕，宝宝出生没多久就近视，比遗传还可怕孕妈多注意	unrelated
大咖头条 出轨大戏再次上演！杨幂婚姻遇危机 刘恺威出轨	声音集结号｜谣言粉碎机 之输精管结扎术真的影响性能力吗？	unrelated
刘强东前妻归来，想回京东执掌大权，奶茶妹的反击太霸气	刘强东前妻回归，想要回京东执掌大权，奶茶妹妹的反击太霸气	agreed
医生警告：西瓜千万不能和下面9种食物同吃如“砒霜”	曾被称为春晚歌手，那英追求过他，如今49岁惨淡复出	unrelated
3月06日沪深股市重要公告摘要 一只新股周一发行	奥特佳澄清：重要股东并未“清仓式”减持	unrelated
一年多过去了，宋喆终于被抓最高可判15年，马蓉期限即将到来！	王宝强前经纪人宋喆被抓，律师称若罪名成立，最高可判15年	agreed
大妈爱不释手的丝瓜，快速淡斑美白，3天改善肤色，肌肤嫩白透净	野生堀北真希逛超市！「透白美肌+大电眼」打碎变大妈谣言	unrelated
生男生女？这些藏在B超单中的“秘密”，医生绝对不会说	香港又检验出38款致癌洗发水，7大品牌超标，你家用的上榜了吗	unrelated
孙红雷王思聪轮番“炮轰”那英，她到底“毁了”多少好歌手	孙红雷王思聪联手炮轰那英：那样的人怎能做导师？	agreed
杨洋喜欢郑爽想表白郑爽却不好意思，好 羞哦	郑爽主动表白，杨洋高冷拒绝	unrelated
一夜软化，两周祛痘了无痕，只是每天用白醋加它洗下脸	好用｜祛痘、紧致、抗皱的修复精华，一夜之间让皮肤变好	unrelated
美要求中国大飞机遵循西方标准，否则不承认，中国：我们承认就行	冯提莫被爆猛料清纯不在，王思聪：冯提莫你也太差劲了！	unrelated
王诗龄喊姚明女儿农村娃？王岳伦终于发飙了	郑爽建群每人收200块：这年头，造谣一张嘴，辟谣跑断腿！	unrelated
女子每晚睡醒身上出现莫名淤伤，装上监控后拍到了奇异画面	夏天蚊子最怕这种植物！家里摆两盆，带给家人舒适的居家环境	unrelated
牙膏这样用，淡斑不用愁，3次脸上斑点全部扫光光	牙膏这样用,祛斑不用愁,3次脸上斑点全部扫光光 皮肤白净	agreed
农民能享受的10大政府特别补助，农村人得知道	农业户口取消 农民依然享受各类农业补助，还有其他的福利在后头	unrelated
农村田间随处可见的野菜，不但能保肝排便，居然还是白发的克星！	肝病不痛不痒，一旦发现就是晚期，农村一野草肝病克星	unrelated
网上说“路由器”会释放甲醛？这是真吗？	玩雪会伤害眼睛？路由器久开会释放甲醛？这些都是谣言！	unrelated
世界首富去非诚勿扰相亲，24位美女全部灭灯，尴尬了	一上台24盏灯全灭，农村小伙竟拿出一样东西，心动女立马同意	unrelated
一招识别地沟油	怎么区分地沟油	agreed
农民不愁赚钱了，国家给农村带来6大项目，明年将“全面启动”！	好消息！已确定朱之文携手于文华登2018年春晚，合唱这首歌！	unrelated
刘恺威的生日礼物难道是小小糯米？杨幂二胎了？	杨幂街边孕妇站姿疑怀二胎 刘恺威情难自已：老婆我爱你	unrelated
18艘军舰！中国又做成一笔大生意 这国快成第二个“巴铁”	这国一口气要造18艘军舰，中国将再获得数十亿订单？	agreed
每一批的光绪元宝都极为精巧、价值百万！	福建官局造的光绪元宝，原来这么有价值	agreed
好消息！不会再有农民工了，农村人的身价将倍增！	好消息！农村人的身价将倍增！不会再有农民工了！	agreed
空心西红柿是打了激素	「辟谣」空心西红柿是打了激素？还敢不敢吃……	disagreed
“家中父母被烧双亡，急寻郴州打工者杨星”系谣言	网警辟谣：从三亚来了100个外地人偷孩子？系旧谣新传！	unrelated
王诗龄嫌弃姚明女儿？王岳伦为维护女儿飙脏话？到底发生了什么	谢娜李湘没有不和属谣言，李湘微博发出温馨祝福造谣者打脸	unrelated
肚子赘肉一抓一把肉？生姜这么用，瘦到你想胖！	肚子赘肉一抓四层肉？去厨房拿片生姜，用一个瘦一个，瘦到你想哭	agreed
不要在黑暗中看手机!易失明!	太可怕了！晚上熄灯后千万不要看手机	agreed
帕尔梅拉斯打算引进高拉特	7月1日起驾考难度再升级，考到的已在偷乐了，没考到的只能加油	unrelated
吴亦凡被爆吸毒 13秒“摇头”影片疯传	抖音官方回应“马桶门”事件：视频未上架，系有组织恶意造谣	unrelated
悉尼海滩现神秘蓝色生物 如同袖珍异形龙引人们围观	野外骑车拍摄到神秘人形生物闪过	unrelated
自配药酒请客 5人中毒身亡	青田一居民饮用自配药酒5人中毒身亡	unrelated
操作小领域暴利项目，年赚百万思路分享	人气最高，投资最低的暴利项目，虽然不起眼，但是能年赚30万	unrelated
宋晓峰做传销，差点把传销公司吃破产	宋晓峰做传销，差点把公司吃破产！不服不行	agreed
美人鱼真的可能存在吗	我的天，传说中的美人鱼真的存在，海滩发现美人鱼尸体	unrelated
常用家电「辐射」排行榜出炉！辐射最大的居然不是微波炉	手机辐射相关七大谣言：手机打电话过长会导致耳热、头疼	unrelated
斯科拉里回来了 明年欲带领升班马搅乱中超棋局	卓尔辟谣“欠水费”事件！声明：俱乐部运转一切正常	unrelated
有白发，不用怕！洗头加点这个，一招搞定3天白发快速变黑！	白发用香蕉皮配它洗头，10年白发5天变黑，简单快速，杠杠的！	unrelated
满嘴口臭胃火大？两个妙招几毛钱，10年口臭当天去除	口臭口苦？当天去口臭！10年的口臭1天就去除！	agreed
拔智齿瘦脸？拔智齿影响智力？智齿到底该不该拔？	蛀牙用韭菜籽熏出的虫子到底是什么？牙科医生：谣言！并非虫牙！	unrelated
农村没缴或补缴养老保险的快来看看，如何缴纳或补缴？	农村养老保险一次性补缴15年，60岁后每月可领1300元吗？	unrelated
「误以为是」吃鼻涕有益身体健康？耳朵进水会得中耳炎？	耳朵进水了，就要发炎，还经常这样。会引起头晕吗？	unrelated
网传海湖新区发生坠楼事件！真相来了...	湖南男子因孩子吃肉松腹疼编造谣言 被行政拘留五日	unrelated
微信交易记录怎么查询 交易记录查询方法	科普：如何查询删掉的微信聊天记录，太有用了	unrelated
大蒜加它一起吃，防血栓，延缓衰老，一生不得癌症！	非常适合女人吃的一种食物，补血养颜温和养胃，祛湿利尿	unrelated
乐山警察打人	男子拒不出示驾驶证还诬赖警察打人 围观群众澄清真相	unrelated
爆脾气的韩红体重成谜，却一直拒绝体检，不小心说出理由让人泪奔	范冰冰用事实证明不敢回国是谣言，如今风波后低调现身做慈善公益	unrelated
同仁营养师：吃蘑菇会引起重金属中毒吗？	吃鱼时千万避开这两个部位，重金属含量高, 常吃极易中毒、致癌	unrelated
小孩出现4个症状，离儿童白血病只有一步之遥！宝爸宝妈多多留心	儿童乳饮料中含有肉毒杆菌会致白血病？谣言！	unrelated
7月1日起，支付宝余额宝自由存取功能将受限！	银行：你对力量一无所知 支付宝余额宝7月1日将不能自由存取	agreed
网传年近五十吴奇隆没有生育能力，刘诗诗已和他离婚！叹息……	铜币之首光绪元宝赏析	unrelated
34岁孕妈怀孕7个月检查畸形，不听劝非要生下孩子！	孕妈注意！孩子又胖又娘多因妈妈怀孕时乱吃东西所致	unrelated
全国严查棋牌室，一律逮捕罚款？我差点就信了……	网传衡南两个小孩被挖肾后扔在草丛里？谣言	unrelated
明年起，将重点整治农村这些问题，农民朋友都笑了	农村这三大乱象要重点整治了，带起农民致富了	agreed
建议大家以后多吃点蚕蛹 又便宜又大补	唐艺昕快本撩汉大讲情话，千万别让张若昀看见！这是要分手的节奏	unrelated
武汉取消“九桥一隧一路”ETC收费	武汉ETC要取消？又是谣言！相关部门已报警	unrelated
头发越掉越多别着急！洗头时加点它，最快3天头发乌黑又浓密！	洋葱+生姜洗头，滋养头发，3天乌黑，永不褪色，不学可惜了！	unrelated
死亡率最高的五款车，日系思域起亚K2上榜，提车的时候考虑清楚	死亡率最高的5款车，就算大减价一样不敢买！	unrelated
生男生女怎么判断，这4种情况容易生女孩	妊娠中线发黑是男孩 另外这三种方法判断生男生女也超准	unrelated
农村扶贫政策重大调整，贫困农民可以领到这些补贴了	6种减肥期间不能吃的水果，芒果就是其中一个，你中了吗？	unrelated
周润发结婚32年没有孩子，与赵雅芝私生女已经22岁？	水电必须开槽？装修32年老师傅辟谣，你肯定又被坑了！	unrelated
李易峰吸毒吗 事实真相原来竟是这样	姚明吸毒被抓？谣言！	unrelated
李易峰在微博宣布恋情	王宝强给新女友买百万豪车，女友正面照流出，网友：果然没猜错	unrelated
听说沙溢出轨外围女	沙溢 出轨的后续 以及他和杨子珊的陈年旧事	agreed
每天早上喝一碗开水冲鸡蛋，拌白糖有营养吗？说出来你不会相信的	白糖蒸鸡蛋能毒死人，鸡蛋和白糖可以同吃吗？谣言？	unrelated
唐嫣或走杨幂老路婚姻不幸福：唐嫣罗晋黑脸冷战？	唐嫣罗晋冷战？杨幂赵丽颖互黑？张雪迎获大咖提携？黄景瑜会挑戏	unrelated
冯小刚新作《芳华》惨遭下架，原因究竟是什么？	《芳华》撤出国庆档与钱无关 宣传方辟谣：让七亿回本见鬼去吧！	unrelated
明年起，这些年检收费项目将全部取消！为大家省一笔钱	交通部：注意了！明年起取消年检收费项目，但将新增一检测项目！	unrelated
国家出台最新补贴政策，农村退伍老兵有福了！	沈腾录节目突然晕倒，谢娜这次玩大了	unrelated
白发别去染，白醋加它洗头，10分钟头发乌润如墨，靓丽有光泽	侦探来啦！刷爆票圈的碱性水真的更有益健康吗？	unrelated
花椒和它磨成粉，贴在肚脐一整晚，10天瘦20斤，排湿毒治便秘	花椒这样贴在肚脐上，3天排湿毒治便秘，20天瘦了28斤	agreed
男性多吃酸就容易生男孩？	没孕期女翻男 说下怀女宝症状 接女宝的来吧	unrelated
农村房屋要统一规划，每户补贴18万，这几不在规划之内！	辟谣！农村房屋统一规划，每户补贴18万？真实情况是……	unrelated
ios版微信连夜取消了赞赏，连二维码赞赏也不行了	微信网页版将关闭？微信辟谣：传言不实	unrelated
女明星杨幂被潜规则，心里话第一次被潜规则确实很难过。	杨幂 评价娱乐圈潜规则 相辅相成 互相推动	agreed
关晓彤鹿晗在一起接吻，网友说关晓彤太小，关晓彤这样霸气回应！	鹿晗关晓彤路边深情拥吻遭批，关晓彤霸气回应：我成年了！	agreed
刘诗诗挺孕肚现身，吴奇隆要当爹了！	刘诗诗挺孕肚现身孕味十足，网友直呼：认不出来！	agreed
校外机构与海师大合作成人教育招生？辟谣：谨防上当受骗	辟谣｜成人教育、自学考试明年恐被取消，部分学校停止招生	unrelated
为什么酒店的烧水壶不能用?一辈子的阴影!	听说酒店的水壶不能用，很多女客用它煮内裤，但这样真的管用么？	agreed
农村大集上，这个生意越到过年越火，好到爆，这也是小时候的最爱	手机辐射能爆爆米花？谣言！	unrelated
糖尿病人不能吃水果？那是你没遇到这几种	张杰谢娜离婚事件惊爆粉丝 男神将和邓紫棋结婚？	unrelated
澳洲发现神秘生物，正趴在沙滩晒太阳！	看不懂!马思纯自曝跟周冬雨关系一般	unrelated
外国猎人展示如何用狗狗狩猎野猪，5条猎狗被咬死一条猎狗重伤！	美国大型比特犬咬死女主人 警方辟谣	unrelated
周立波出事 凤姐在事件营销 有仇必报的郭德纲在酝酿大招	周立波说马云拜访了谁 谁就会出事 究竟马云都拜访了谁	unrelated
人工合成的这4种食物，虽好吃但很脏，相信你一定都吃过	我们平时吃的很多很常见的这3种食物，居然都是人工合成的！	agreed
卓伟团队再发力，蓝洁瑛指控二十年前遭曾志伟性侵	女学生支教却遭强奸？又一个“造谣样本”！｜沸腾	unrelated
祛湿减肥只要一招，不用饿肚子就能瘦身的神奇小妙招	香菜这样吃，祛湿刮油瘦肚子，减肥只需这一招	unrelated
小米回应陆奇将加盟：谣言	传陆奇将加盟小米负责移动AI事业部，小米称谣言	unrelated
皮皮虾喊冤：不是注胶，是虾黄虾膏！我们走！	辟谣！网传四川泸州抢小孩视频实为醉汉追赶4少年	unrelated
中国最牛的十大高校，它们的王牌专业你知道吗？	江西某高校王牌专业大学生：诊所上班遇检查脱白大褂躲仓库	unrelated
伊利董事长潘刚失联被带走调查？潘刚最新消息	中国平安回应传闻：公司董事长变更系谣言	unrelated
80岁老中医治胃病的偏方，一招去除胃病胃痛，不反复	简单的中药，让几年胃病去根了，良药一味抵千军！	agreed
杨幂唐嫣开撕，塑料姐妹花实锤？刘空青：两人貌合神离，分道扬镳	杨幂工作室发声明辟谣言，塑料姐妹花，网友：这对名副其实	unrelated
「真相」邛崃朋友圈疯转2018年免交新农村合作医疗费？	辟谣：2017年新农合不用缴费，已开始退款？假的！	unrelated
网售洗眼液能洗出眼内寄生虫？专家解释白色沉淀物只是黏蛋白！	【央视辟谣！对虾体内有白色寄生虫？扩散真	unrelated
姚明拒代言丰田让我们骄傲，同时表示女儿18岁后自己担当	明星该不该代言日货，姚明毅然拒绝，胡歌被骗砸弯脊梁	unrelated
一把大枣胜过百副药，腰椎间盘突出三天缓解，十天根除不复发！	一把艾草，加4两酒根治我8年的腰间盘突出 颈椎病 可以转发！	unrelated
暴涨的包浆硬币，可能你家里就有，一枚顶百枚，不要乱花了	24岁昆凌腹部凸起疑似怀有三胎，难怪周董近期护妻心切	unrelated
傻女人都不知道，睡前用它洗脸，秒美白祛皱，祛斑，祛痘！	中医讲生姜也能祛斑，美白肌肤，但是这些人切记不能用	unrelated
东太行景区玻璃栈道上的玻璃“碎”了 游人直接被吓趴	官方辟谣：北京什刹海景区今晚没有元宵节灯会	unrelated
经常使用支付宝和微信付钱，建议关闭这个功能防止钱包被盗！	6月30日后支付宝不能刷银行卡？支付宝：都是谣言！	unrelated
土豆皮熬水染发，白发立即变黑？这样治疗白发才有效又安全	土豆皮熬水染发，白发立即变黑？这样染发又健康有有效！	agreed
农村这几个证将“停止办理”倒计时两个月，农民再不抓紧就晚了！	农村户口即将取消，农民朋友要把这两个证办好	unrelated
我的脏了这样擦，半年不沾灰尘，光亮照人	还在爬上爬下擦玻璃，教你一招半年不沾灰尘	agreed
知情人爆白百何陈羽凡分居未办离婚手续！《人民》导演不拍续集？	知情人：白百何陈羽凡没办离婚 她现在每天哭	agreed
孩子严重咳嗽，婆婆拒绝治疗，原因却是“雾化比输液危害更大”！	给孩子用雾化就是滥用抗生素？“辟谣”反变“造谣”！	unrelated
你知道哪些把腐烂香蕉恢复新鲜的小窍门？	把腐烂香蕉恢复新鲜的小窍门	agreed
千年女尸竟产下14斤活女婴#晒晒年终奖#	不腐女尸 千年容貌未变栩栩如生	agreed
网爆乔任梁死因与王思聪有关，经纪人怒斥谣言	陈嘉上自怒斥谣言：性侵郑爽？愿意和她对质	unrelated
脾虚导致肥胖？用醋泡香蕉，补脾又减肥	醋泡香蕉可以减肥吗 香蕉醋减肥法	agreed
坏人为了找到妹妹的死因，故意用成龙的女儿威胁他	小混混威胁成龙，怎么死的都不知道	unrelated
微信聊天记录删除了怎么恢复？微信聊天记录怎么查	上港严正辟谣：绝无球员赌球，有人捏造微信聊天记录	unrelated
想知道老公确切位置，打开微信这个开关，1秒钟就能精确定位！	查岗神器微信定位找人微信朋友圈一张照片就能定位对方的具体位置	agreed
最健康的3种小零食，不只好吃，对身体健康也有很大好处！	刘恺威苦求复合，杨幂狠心离婚，不要孩子？	unrelated
灰指甲难治愈？用这个小偏方加上配方，彻底根除灰指甲不在话下	治疗灰指甲的小偏方2天见效，彻底根除灰指甲的办法，治愈不复发	agreed
王者荣耀团队年终奖100个月工资？	辟谣！五莲天然气要涨价？官方回复来了！	unrelated
171斤减到105斤，专家教你这样喝，刮油消脂，快来了解一下	171斤减到97斤，自制瘦身液，饭后喝一杯，甩掉水桶腰	unrelated
微信账户二次实名认证	网传“邮政网银账户进行实名补录认证”这是谣言！	unrelated
红庙路交叉口小孩被抱走	柠檬加一物，竟然是美白淡斑利器，一周见效！	unrelated
你觉得李易峰吸毒了吗？	吸毒？李易峰？看他怎么说得清？	unrelated
真相大揭秘~澳大利亚对中国护照免签了？	加拿大留学费用真的那么可怕么？究竟谁在谣言	unrelated
新补贴又来了农村这4类人可领	2017农村低保新政策重大调整，农民朋友可以领取这四大补贴	unrelated
50年最强冷空气来袭？气象部门：气温偏低，降水偏少	50年最强冷空气将来？中国气象局已辟谣	disagreed
洋葱配上它，预防血管堵塞，还能稳血压，心血管患者都在吃！	经常吃点这些“血管清道夫”食物，长久血管不堵塞，血液不粘稠	unrelated
39周孕妇生宝宝前投三分球“神准” 网友：这个儿子可能是巨星	孕妇剖宫产下六斤重儿子，只为让爸爸看一眼宝宝	unrelated
1993工作，24年教龄的一线教师工资经历过这些次的调整！	南昌要加快推进备用水源建设 提高教师教龄工资鼓励终身从教	unrelated
网传刚生完孩子就离婚，谢娜baby纷纷躺枪？	谢娜被传闻和张杰离婚事件后，现身机场，心情怡然自得！	unrelated
杨梅还有这种功效——防癌抗癌、美容减肥	王宝强和马蓉离婚后第一次见女儿痛哭？	unrelated
农村，五种抗癌野菜，你知道吗？	5种抗癌野菜，就藏在农村，城里很难买到的，赶紧告诉家人！	agreed
痛风折磨人，别慌！中医治疗有妙招！	谣言粉碎机｜抽烟只伤肺不伤心？不吃海鲜，痛风就不会发作吗？	unrelated
无耻的商家，这是紫菜吗？不要脸的商家，是塑料袋做的吧！！	塑料袋紫菜，什么能把它消化，你是垃圾回收站吗？	agreed
保鲜膜会让食物携带致癌物质？	保鲜膜含有致癌物质？	agreed
秦始皇探寻一生的长生不老方法，竟然被他们发现了5种！	肝胆外科主任：以下几个症状，是肝癌早期	unrelated
中国有共享单车，美国街头出现共享枪支，你怎么看呢？	以色列街头出现共享枪支	unrelated
大肚子福音，五味中药煮水喝，降脂排毒，瘦下来很轻松	天后终于怀孕，三个孩子四个爹？谢霆锋成笑柄	unrelated
家里有当兵的来看看，农村退伍军人有福了，国家将负责安排就业！	农村退伍军人注意，三大补贴即将降临，你们要等着坐收福利了	unrelated
白发变黑有救星了，用它洗头，白发马上变黑发，效果堪比染发剂	洗头时用藿香水，九年白发7天变黑，永不反弹！收藏了	unrelated
捏造宜泸高速严重车祸 宜宾一小区保安被拘留9天	注意！近期在朋友圈造谣宜泸高速重大车祸的被拘留了……	unrelated
“解放军澳门杀人”？澳门政府气急眼了，直接出面！	震惊吗？澳门政府：“解放军杀人谣言”是从美国传过来的！	unrelated
王菲李亚鹏在爆孽缘，谢霆锋写情书给王菲，成离婚火线导锁！	世大运爆四大乱象 台北市官员亲上火线辟谣	unrelated
日本逆天的医疗科技竟然发达到可以选择未来宝宝的性别?!	陈皮这样泡水喝，可排毒燃脂，轻松甩掉全身肥肉	unrelated
55岁男子患肝癌15年，每天都吃这东西，1个月后癌细胞全死光	30岁男子患肝癌2年，每天吃点这东西，一个月后癌细胞全死光	agreed
腰间盘突出别再傻傻吃止痛药了，简单治腰疼方法教给你！	腰间盘突出治起来很简单，只要找对了方法，腰疼真的不是事儿	agreed
孙俪在机场发脾气，邓超在旁边不敢言，孙俪家庭地位真高	孙俪邓超机场吵架大打出手，感情破裂走到尽头	agreed
独生子女的父母请注意，这4项补贴，只有你们才能领！	独生子女的福利来了！这四项补贴，只有独生子女父母可以领取！	agreed
别再用淘米水洗头了！洋葱加上它才是治疗白发的良方！	洋葱能洗头，把白发调理成黑发吗？	unrelated
手上有个川字会离婚	听说手合拢有川字的会离婚，反正我是信了	unrelated
网传“多人感染SK5病毒死亡”系旧谣新传	江苏辟谣“SK5病毒致死”事件 散布谣言者已被拘留	unrelated
湿气的“死对头”,晚上吃一口，湿气排得一干二净，体重也降了	湿气的“死对头”，晚上吃一口，湿气祛得一干二净，体重也降了！	agreed
166减到91斤，睡前喝一杯，减肥效果翻倍，水桶腰迅速消失	141斤减到87斤，坚持每天喝一杯，简单易学，快来了解一下	agreed
景甜的家庭背景遭质疑，景甜母亲这样回应！	辛芷蕾辟谣霸气否认抢景甜金主传闻：没金主,谢谢！	unrelated
小海绵正面照终曝光，真是迷你版的黄晓明！	Baby儿子小海绵正面照首次曝光 简直是迷你版黄晓明	agreed
物业服务不到位 业主拒缴物业费反被索要滞纳金	辟谣丨物业公示“人贩子”照片？假的！别再转了	unrelated
有妙招，支付宝提现收费变“免费”?	耶！可以继续买买买了 支付宝辟谣：不会关闭刷银行卡功能	unrelated
网传平罗六中学生打死人？假的！	白大拿辟谣：梅威瑟不会在八角笼打比赛，会被打死的	unrelated
微信聊天记录删除了怎么找回？可以查看别人的微信聊天记录么	老公删除了微信聊天记录，我们的感情是否遭遇了危机	unrelated
坦克退役后，美国扔进太平洋，俄罗斯丢进坟场，中国居然这样做！	各国坦克退役后都是如何处理的？美国令人无语，中国备受称赞	unrelated
白头发多？洗头加点它，4天白发变黑发，不用在染发啦	五片桔子皮这样洗头，20年白发，三天就全黑了，告别染发	unrelated
国家对农村违规整顿了，清退4类低保，严查5种人，处理3个问题	辟谣！2020年国家将全部取消农村低保？请不要吓唬老农民！	unrelated
库尔德武装快撑不住了！美中将亲临前线威胁对土耳其开战	土耳其屯兵10万，准备与美小弟开战？	unrelated
微信清理僵尸粉小技巧，干货！	微信又一次更新，能批量清理”僵尸粉“？	unrelated
姚明女儿与李湘女儿参加同一节目，被王诗龄说成农村来的	《飞翔诗话：李湘女儿称呼姚明女儿“农村娃”》	unrelated
第四套人民币已经退出市场，这种钱币也升值了那么多！你知道吗？	第四套人民币5角纸币别再乱花 仔细保存坐等升值！	unrelated
农村老人晚年享清福了，这四项属于老人的补贴，早办不吃亏了	这些新增的农业补贴你知道吗？这四项补贴的标准都已经出来了	unrelated
你真的喝对木瓜汤了吗？木瓜这样吃才能丰胸！	木瓜丰胸的最佳吃法 让你的胸部涨不停	agreed
又有女神怀孕啦！这次是舒淇！	舒淇自嘲虎背熊腰 网友笑侃：恭喜怀孕	agreed
永清县今晚11.30/3.0余震	今晚廊坊永清11点30分有余震？官方：纯属谣言	disagreed
ofo 挪用用户押金超百亿？ofo：绝对未挪用押金	ofo回应“内部贪腐严重”传言：零容忍，一旦查实绝不姑息	unrelated
snh48组合爆出 让未成年女生陪酒	SNH48前成员曝让未成年队员陪酒 官微疑似回应	agreed
学区调整！萨尔图区新生家长注意！你买的学区房可能白买了！	要想报名注册必须先买牛奶？雷州教育局回应“小学牛奶事件”	unrelated
863计划参与者接受采访 王老吉动物试验证明确实寿命延长	“王老吉延长寿命”原来是国家863计划的科研成果	agreed
《人民的名义2》即将开拍，侯亮平陆毅换成老干部，网友不干了	《人民的名义2》已开拍，男主角已换，谁将代替陆毅？	agreed
《爸爸去哪儿》第六季嘉宾最新名单曝光，请了他这么久终于来了	《爸爸去哪儿第六季》嘉宾名单曝光，有你期待的萌娃吗？	agreed
肝脏不好多吃3种食物，养肝补血排毒，还能降血压、血脂	高血压别光吃药！用这些植物的叶子泡水喝，血压悄悄降下来	unrelated
大蒜加它一起吃，防血栓，延缓衰老，一生不得癌症！	女人经期常吃这几种食物，补血暖宫，排毒养颜，远离妇科疾病	unrelated
正黄一角，大家见过吗，一张价值千元！	一张一角纸币价值500元，大家听到后会觉得有点不可思议吗	unrelated
减肥自制生姜减肥法，7天暴瘦10斤，减掉大肚腩，还排毒治便秘	VC防感冒？阿司匹林治百病？7个健康谣言把美国人骗得团团转	unrelated
宋晓峰做传销，差点把传销公司吃破产	国务院让传销合法？又是一大谣言！	unrelated
网传“女子跳楼未遂看热闹小伙坠楼”，原来男子忧郁抑郁症	官方辟谣：“清华北大在成都建分校”消息不实	unrelated
不想接对方电话？教你一招不用关机，手机号秒变空号	不想接电话，不想关机，教你一个方法，手机秒变空号！	agreed
女性生理期常见6大谣言！里面有你一直相信的吗？	小便后擦拭外阴会患妇科病是谣言，不擦才怪，别说你也信了	unrelated
微博宣布退出娱乐圈，发文者并非朱之文本人	大衣哥澄清用朱之文微博诽谤他的视频	unrelated
减肥不吃饭吃什么水果 不能空腹吃的水果	空腹不宜吃的5种水果，误食容易引起腹泻，赶快告诉家人	unrelated
正黄一角，大家见过吗，一张价值千元！	一角纸币绿色蝴蝶纹，一张价值一万，可不要收藏错了	unrelated
唔,得到消息,中国开始从印度撤侨了	《战狼2》很燃?看下真正的中国撤侨,祖国原来这么霸气!	unrelated
刘明炜高考准考证丢失	刘明炜的高考准考证丢了？谣言！许昌人千万不要再传了！	disagreed
梅花五角硬币中这几枚最值钱，可能你手里就有！	最罕见的1993年梅花五角硬币 有就发财了	unrelated
2017年驾驶证“替人销分”新规，驾驶证代扣分已经行不通了！	辟谣：“3月1日销分新规”系误读，九江办理无变化！	unrelated
好消息：农村有四项补贴每项都是几万元，你领了吗？	农村朋友注意：这八项补贴，你领到了吗？	agreed
杨紫：从疑似整容到脸崩、再到与赵丽颖不和，她用演技证明自己！	杨紫当场被主持人问整容，旁边的导演直接懵了！	unrelated
摄像头拍到的神秘生物录像究竟是什么妖怪精灵外星人?	监控录像拍到的神秘生物录像,令人百思不得其解!	agreed
寻人启事称“找到妹妹以身相许” 网警辟谣	辟谣：马鞍山朋友圈疯传的这条寻人启事是假的！	unrelated
杨幂和刘恺威的感情真的不好？刘恺威的“举止”有几个能做到！	对越作战，“三光政策”真的存在？无耻谣言！	unrelated
减肥人士必备家常菜——夏天这样吃，每天瘦半斤	巧吃白萝卜，一天瘦5斤！宿便即清，养颜又护肤！	unrelated
枸杞还在泡水喝？枸杞配它，后劲很大，7天让你肾功能硬气十足！	中医：枸杞这样泡，告别肾无力，精神似小伙，老婆乐开怀	agreed
生姜生发	洗头时加点生姜，生发就是如此简单	unrelated
普京统治了俄罗斯20年，俄罗斯强大了吗？	即将胜选的普京还记得：给我二十年，还你一个强大的俄罗斯吗？	agreed
智商高的孩子，一出生就有这6个特征，对照下你家的有没有？	这个时段睡觉的孩子，智商身高都会更高，你家孩子睡对了吗	unrelated
吉利再创奇迹，4月销量突破12万辆，长城突然有点慌！	领克01卖12.68-19.98万元？吉利官方辟谣：对标途观	unrelated
网传：微信网页版将下线？这是真的嘛？	注意冰箱里打死都不能放的6种食物，拿出来就扔，很多人还不知道	unrelated
大蒜灭蚊比蚊香还管用，老奶奶只用一个口罩，家里的蚊子全不见了	才知道大蒜灭蚊比蚊香还管用，不用买蚊香，家里一直蚊子也看不见	agreed
保定警方辟谣河北“蠡县加油站爆炸” 将严处造谣者	网传大连学生青岛遭绑架 警方辟谣：并未接到报警	unrelated
网友曝李小璐曾和PGONE拍亲密照后又P掉	猫腻！网友曝李小璐曾和PGONE拍亲密照后又P掉	agreed
王宝强一首歌，竟让马蓉哭求复合	马蓉520微博发文回忆爱情，疑似希望与王宝强复合！	agreed
徐峥半夜进错房间，遭抓奸男子暴打	白鸡蛋更有营养	unrelated
柿子酸奶同吃会致死吗？	柿子酸奶同吃有毒？吃完柿子再喝酸奶会死人？	agreed
老公出轨了,要怎么查看他已删除的微信聊天记录了？	5秒钟找回被删除的微信聊天记录，有什么用，你懂的！	agreed
物业无理收费业主只能接受？你错了，这些情况不交物业费也有理	【辟谣】“这8种情况可以不交物业费”是谣言	unrelated
多吃猪蹄能美容？喝豆浆能丰胸？别再信了这些说法都是骗人的	到现在你还深信不疑的养生谣言！猪蹄美容、豆浆丰胸、腰子壮阳！	unrelated
沙湾有人吃羊肉得了SK6病毒？切！我还SK2呢！	吃西瓜会感染“SK5病毒” 系谣言	unrelated
交警提示：2018电子车牌将全面推广！	辟谣：车牌四个孔只装两颗螺丝扣12分？看看车管所怎么说！	unrelated
张柏芝秘密现港遭猜疑 谢霆锋接机证实猜疑 复婚了吗？	张柏芝高调现港 心情大好 粉丝：好事将近 复婚有望？	unrelated
快手二驴 请赵本山女儿球球吃饭 天佑生气了？	二驴的替方丈澄清投票事件 紧要关头谁都不想闹事	unrelated
如果你现在手上有古钱币，下半生可能将不愁	古币-市场真的价值上百万吗？	unrelated
有猫腻？网友曝李小璐曾和PGONE拍亲密照后又P掉	香蕉这样吃，3天排清肠道排湿毒，19天瘦27斤，健康不反弹	unrelated
关于杨钰莹要结婚的消息，甜歌皇后首次微博公开回应	蒙古人吃人？有关蒙古谣言的始作俑者竟然是老外：托勒密	unrelated
小伙地铁装睡拒绝给孕妇让座	广州孕妇称坐地铁常无人让座 是社会太冷漠	unrelated
感染sk5病毒死亡来袭，云南省红河州第一医院躺枪	不信不传！广州警方辟谣：烈士陵园地铁站被水淹了？假的！	unrelated
市教育考试院提醒：高考季网络谣言别中招	高考期间最厉害的谣言：刘明炜的准考证丢了！	unrelated
Untitled马云视频;价值千万值得一看_0	Untitled马云视频;价值千万值得一看_8	agreed
直击马蓉公开表白张杰称想签约他，怀孕中的谢娜替王宝强出了口气	马蓉现身美国街头疑似怀孕，发现了什么？丢掉儿子自己走了？	unrelated
李亚鹏摇身前妻变妹夫，新女友背景曝光竟是王菲的妹妹	李亚鹏新女友曝光 秒变前妻妹夫!新女友竟是王菲的妹妹?	agreed
南京苏宁球迷上吊自杀	【网警辟谣】网传女大学生被两名男子绑架消息不实！	unrelated
聊天记录删除了如何恢复？这才是大家真正需要的方法！	教你怎样恢复QQ聊天记录，恢复QQ好友，QQ群	unrelated
妖股诞生最多：一带一路第一黑马，必将远超天山股份，福建水泥	辟谣！45万亿投资是以讹传讹，不同于当年4万亿	unrelated
男孩要比女孩更聪明？但6岁前，男孩与女孩的差别绝对让你吃惊！	男孩比女孩更聪明，原来还藏着这些原因	agreed
农村的村干部应该有哪些人来当？看看国家出台的新规	郑爽大学时期男友惨遭曝光 长相普通口味重	unrelated
垃圾食品？这个黑锅方便面背不背	【科普】辟谣了！这些电力谣言，这个黑锅我们不背！	unrelated
凤凰古城再度收门票不符合事实，游客交的50块钱去哪了	辟谣！首届石家庄旅发大会期间正定古城各景区门票政策说明	unrelated
离开了马蓉……王宝强新欢熊乃瑾回应 怀孕？	熊乃瑾晒美照疑似怀孕，网友：王宝强的孩儿？	unrelated
有房必知：房产证将下岗 如何证明房子是我的！	勿让房产证“下岗”谣言乱飞	unrelated
中国老板收购欧洲顶级联赛足球队，蒋立章体育版图再扩张	渝媒辟谣力帆买伊涅斯塔 力帆：年龄太大不适合中超	unrelated
猛料｜传首套房首付比例提至35%，买房更难了	辟谣！长春大多数银行首套房首付政策没变化！仍执行最低首付2成	unrelated
班级群传出“偷小孩团伙被抓”，又是假消息！	多地“人贩子偷抢小孩”？放心！警方证实是谣言	unrelated
女儿被人贩子拐走，1年后偶遇女儿，妈妈留下100元后狠心离开	辟谣：“王国军5岁女儿被拐走”是假消息	unrelated
巧用电吹风来治病？真的太神奇了	电吹风让百病皆消	agreed
婚变居然是因为相敬如宾？——属相六合看李小璐贾乃亮婚姻红灯	辟谣贴丨你信错了那些生肖配对	unrelated
华谊兄弟质押股权疑套现，王中军王中磊赚钱有高招	华谊兄弟王中军、王中磊疯狂套现？疑似跑路？华谊兄弟：纯属谣言	unrelated
套路升级！章子怡点评反被怼，张国立5个字打脸《演员的诞生》	《最美表演》打脸《演员的诞生》这10位演员为真正的演员正名	unrelated
李雨桐再度实锤薛之谦！不做歌手也要弄死我，劈腿闺蜜人渣本性	好消息：2018年农村独生子女家庭补贴福利，附带申请流程！	unrelated
牛人自制永动机，真的停不下来	科学：民间牛人自制永动机，学者都服了	agreed
凤凰传奇解散了！玲花含泪唱了这首歌，观众哭的撕心裂肺，太扎心	凤凰传奇被迫解散？终于找到这首唯一由男方主唱的一首歌了！	unrelated
怀男宝的孕期症状，看看你有吗	没想到我也女翻男了，二胎如愿凑成好字啦，附怀孕期症状和小王子	agreed
恒大敲定奥巴梅扬！德甲结束后将来中超	拉涅利：中超想买斯利马尼？全是谣言	unrelated
电饭煲上油污多？教你一招不用一滴水，轻松清除电饭煲污渍！	10年老铁生锈一点都不慌，一个土豆教你搞定一切，轻松祛除铁锈	unrelated
微波炉的辐射是不是特别高？对人体有多大的危害？	吃被微波炉加热过的食物会致癌？营养师：你被这个谣言骗了很久	unrelated
便秘还没好？中医博士给你支招治便秘 一招让你畅通	一招快速治疗便秘	agreed
红庙路交叉口小孩被抱走	《老周鬼点子》自制淡斑美白面膜，一周就能看到效果，无副作用	unrelated
农民退出农村土地，可获得10万补偿！	农村开始整顿空心房，拆农房领补偿最高10万，你愿意被拆吗？	unrelated
什么？谢母狄波拉爆谢霆锋与张柏芝又复合，现正在商议复婚	谢霆锋接儿子上学，疑与张柏芝复婚谈判中	unrelated
王宝强离婚后首次公开亮相,携处女座《大闹天竺》现身发布会	张馨予携发小现身终止“坐台”谣言 现场激动洒泪	unrelated
截止9月底，农村的这3项收费将彻底取消，农民别再白白交钱了！	农民朋友不要交钱了，9月份起农村四项收费全部取消~	agreed
申花夺足协杯冠军，续约莫雷诺，躺冠特维斯决赛日已回阿根廷	亚冠失利特维斯发怒有意离申花？经纪人辟谣：一派胡言	unrelated
张柏芝说2018要生娃 有新男友了？	娱乐记-有新男友？张柏芝丢震撼弹：2018必定要生出BB来	agreed
晚饭不吃，真的有益于健康吗？	晚间语录：晚饭不吃，真的有益于健康吗？	agreed
农民看病难？明年这9种疾病免费治疗！农民朋友再也不用愁	农民有福了！农村医疗新规出炉，这几类疾病能免费治疗了	agreed
儿童饮食健康，应避免乱喝饮料？	儿童白血病，竟然和这些甜饮料有关？	unrelated
晚上吃它等于慢性自杀，第一个你就经常吃！为了孩子，还不快看！	不要给孩子晚上吃这些食物，吃多了等同于慢性自杀	agreed
在农村，以下7种农房要保不住了，老家有房的看看吧！	什么情况？等到明年农村这7种“农房”，一个都“保不住”了！	agreed
十胖九湿，三味中药煮水喝，刮油排毒，告别大肚子	有了新车，在新车磨合期需不需要拉一下高速呢？	unrelated
监狱老大欺负八路军特种兵，没想到被特种兵一招搞定，高手！	监狱一伙人欺负新来的小伙，谁知道小伙是位一等一的高手！	unrelated
科技界乍现言承旭林志玲复合疑云！魅蓝毫无预警地被“下架”？	魅族员工辟谣新Logo 变相承认魅蓝将分家	unrelated
手机最好打开这个功能，可以避免手机感染病毒，越快越好	安卓再现新病毒，每天1.3万部手机被感染，100万个账号被控	unrelated
恶婆婆逼走怀孕儿媳妇，没想到走到半路羊水就破了	恶婆婆把怀孕儿媳逼得离家出走，结果半路羊水破了，这下惨了	agreed
在海口买学区房，要是不知道这些你就白买了	谢霆锋被曝欲与王菲结婚 遭到父亲谢贤强烈反对	unrelated
‘凤凰传奇’组合是真的因为玲花老公吃醋，要解散了吗？	「辟谣」听说张飞是美男子？错！他还是丑男！	unrelated
泉南高速一牵引车发生爆炸？	有传言称武黄高速发生车辆爆炸？高速交警辟谣：是自燃！	unrelated
中医说正确食用鸡蛋，加上一两枸杞+10颗红枣，竟然摆脱前列腺	枸杞桂圆加红枣，半个月剔除前列腺，再也不复发！	agreed
廉价版iPhone X曝光：苹果要加入屏下指纹！	辟谣！苹果怒了 坚决不会降低精确度来提高产能	unrelated
二胎生男生女跟头胎有关系，你知道嘛	生姜加上‘它’，2天美白祛斑，50岁大姐嫩白如雪	unrelated
15个你不敢相信但真实存在的怪异动物	15个真实存在的女巫被拍到	unrelated
孩子在学拉丁舞？可能会引起性早熟？	拉丁舞诱发性早熟？辟谣！不能忍！	disagreed
丹阳公交站台前后50米停靠车辆，罚款千元	榆林：“公交站台前后50米禁止社会车辆停靠”系谣言	unrelated
张一山低调承认自己恋情，因要保护她不想公开	张彬彬恋情曝光！热巴不如经纪人小姐姐？	unrelated
瘦子健身3个月、半年及一年增肌多少斤？小伙记录了自己的转变	卧推伤肩？粉碎4大卧推谣言！	unrelated
注重个人发展不解散 TFBOYS成立个人工作室	TFBOYS面临解散，王俊凯频接电影无暇合体，其他两只拖后腿	unrelated
“营山警察*人！女的开车一直撞”系不实言论	南京地铁警方辟谣：带白酒过安检被要求喝一口？纯属误传	unrelated
正在吃中药的肿瘤患者不可食用萝卜、绿豆，不能饮茶和醋？	有水鬼拉人 村民抽干水库 捕获可怕动物 胆小勿看	unrelated
杨幂怀二胎，刘恺威已默认，小小糯米将要出生	杨幂怀小小糯米，直接打卓伟的脸，“离婚”谣言不攻自破	unrelated
于文华终于答应嫁给尹相杰！婚礼上唱了这首歌，尹相杰泪流满面！	于文华终于答应嫁给尹相杰，婚礼上一首歌，唱的尹相杰嚎啕大哭！	agreed
治愈肾结石的小妙招，轻松排出结石不复发，再也不用担心肾结石了	排出肾结石小妙招	agreed
“牡丹江二院门口杀人”？谣言！	泉州警方回应“棍棒打老人”视频：系国外发生	unrelated
网曝一物业提示街头赠送的钥匙扣藏追踪器 警方称未发现此类案件	真的假的?网传街头免费钥匙扣藏追踪器	agreed
传奇拳王的倒下，泰森、罗伊琼斯、克里琴科！都惊呆了	英雄迟暮，泰森挨到十几拳终于倒下了，王朝覆灭，心疼泰森	unrelated
范冰冰和猫猫比睡相 素颜出镜的她真是个“睡美人”婚房也曝光了	范冰冰婚房疑似曝光，网友：有了婚房也结不了婚！	unrelated
秒杀杨幂唐嫣塑料姐妹情，“假脸姐妹团”才是真撕逼啊！	甘薇李小璐负面遭昔日姐妹熊乃瑾点赞，辟谣称手滑，网友两字回应	unrelated
为何应该给农村地区提高补贴？	光伏电价调整谣言满天飞：“没有一个说法是完全准确的”	unrelated
太原千峰北路发生爆炸了？太原网警公安调查结果！	网警辟谣！广西人朋友圈疯传的入室盗窃视频，真相是……	unrelated
李小璐有悔改之意，贾乃亮已原谅李小璐，请不要再伤害他们的孩子	贾乃亮辟谣：甜馨被问“妈妈给谁戴绿帽子”视频系后期合成	unrelated
区块链每日消息解读｜币安投资区块链电竞投票平台chiliZ	B圈八大谣言出炉！中国央行全面禁止加密货币交易？都是假消息！	unrelated
大连中石油石化分公司爆炸大火-2	大连石油罐爆炸	unrelated
37岁罗晋自曝结婚证，唐嫣回应“怀孕”传闻将在意大利举办婚礼	马蓉要签约张杰，你们知道吗？谢娜坐不住了	unrelated
全面取消中考？美术纳入高考？不属实！	浙江新高考“弃考物理”风波：教育厅辟谣能缓解考生恐慌吗	unrelated
男子划伤舌头恶化舌癌，其实喝它可以预防很多人不知道	吃蚕豆划伤舌头，竟恶化成舌癌！医生：学会防癌方法	agreed
同样是做店铺淘宝客，为什么别人能够月入过万，而有些人却封店了	新的赚钱模式，已有人靠它月入过万	unrelated
上海出最严共享单车限制令，即日起暂停新增投放共享单车！	合肥小黄车车座被插艾滋针？谣言！为增加粉丝量	unrelated
1981年香港狐仙事件 狐仙真的存在？	美剧格林里的狐仙在现实当中是存在的 与我们共同生活在这个世界	agreed
苹果打蜡会致癌？到底苹果打蜡能不能吃？	民间治疗耳聋耳鸣的“特效药”，在农村被当成杂草除掉，太可惜了	unrelated
孕妇剖腹产时被医院偷肾？所谓“丧尽天良”，其实是旧谣新传	石油小学附近有人偷孩子？锦州警方辟谣还原事件真相	unrelated
婆婆用一块山楂害儿媳流产，公公当场发飙！	一片山楂竟害的儿媳差点流产，不料婆婆却赖奶奶头上公公听了发飙	agreed
大众甲壳虫停产	辟谣！甲壳虫不会停产	unrelated
专家说，备孕期间多吃这些美食，更容易生出双胞胎	想要备孕生男孩别纠结，注意这些房事很重要！	unrelated
南京大学仙林校区生态环境是有多好？发现野猪成群后，狐狸都来了	南京大学出现了野猪？还有狐狸？来用卫星地图看一下	agreed
听说圆通快递要倒闭，顺丰公司要上市？	圆通被传倒闭系闹剧 圆通西北管理区发声明辟谣	unrelated
自制酵母粉	自制酵母粉！再也不用花钱买酵母粉了！	agreed
胡歌被下属骗搞传销，发现猫腻后，疯狂追车.mp4	胡歌陷入传销组织，长期被洗脑，彻底沦陷了，网友炸锅了！	unrelated
李小璐事件再起风波，小甜馨竟被利用，贾乃亮霸道回应！	辟谣！恶意伪造甜馨视频，贾乃亮工作室：法律追究，绝不姑息	unrelated
55岁李连杰宣布出家，裸捐60亿，弥补自己的过错！	李连杰宣布出家，66亿身家全部捐出，只为弥补“改国籍”失误！	agreed
宋小宝演讲重回课堂，马云都坐下来认真听讲 10	宋小宝演讲重回课堂，马云都坐下来认真听讲 8	agreed
最高补贴55万！唐山农村有地的快看，最新通知来了	农村补贴最新政策：现在回农村种地最高可领5万补贴！	unrelated
王宝强交新女友？送女友价值400万豪车，颜值比马蓉强百倍	王宝强交新女友了？送她价值400万豪车，重点是还美过马蓉！	agreed
交警救人被传“讹人”	交警被干倒？躺地讹人？谣言！执法记录仪拍下真相！	unrelated
吃大盘鸡、泡椒凤爪能感染H7N9？	《辟谣》吃大盘鸡感染H7N9病毒？这是谣言	unrelated
一有眼袋就打玻尿酸？别傻！药店“3元钱”的药膏，轻松消除眼袋	有眼袋只能打“玻尿酸“？别傻！药店三块钱药膏轻松去除	agreed
在农村满足以下几个条件能拿到建房补贴，很多农民朋友却不知道！	国家再出援手，帮四类农村家庭盖房，同时下发高额补贴，农民笑了	unrelated
一招让你的微信减少1-5GB，还能保留重要聊天记录！	“手机比马桶还脏”，这种谣言你还要信多久！	unrelated
一枚开国纪念币而已，纪念收藏的价值真的有百万这么高吗？	孙中山开国纪念币价值百万，是真是假？又有哪些区别？	unrelated
用完电脑洗把脸不会减少辐射 _	话说玩会电脑再去洗个脸能减轻点辐射?_	unrelated
苏州楼市限购满月网友观望中介萧条 银行放贷正常	停贷谣言已证伪 房贷利率优惠缩水是真烦人	unrelated
何洁今天离婚，要求出轨丈夫赫子铭净身出户，可事实是怎样的呢	何洁离婚案开庭，赫子铭是否净身出户？	agreed
周杰伦豪宅大曝光，不愧是吸金王！昆凌也太幸福了！网友惊呆了！	周杰伦1.2亿豪宅再被曝光 昆凌公开顶楼360度观景台	agreed
90后小伙毕业3年买下宝马，但朋友没几个看得起他	每天一杯，刮脂减肥效果好，一周体轻3斤！	unrelated
治疗腰间盘突出最便宜最有效果的方法，重点是不复发	猪蹄的巧妙做法，腰腿疼痛、手脚发麻，多年腰间盘突出也有效！	unrelated
专家已经明确致癌的4种蔬菜，赶紧告诉家里人	一直喜欢的这3种蔬菜不但“有毒”还致癌？现在知道还不晚	agreed
李小璐终获得原谅？贾乃亮病倒，李小璐悉心照料！	李小璐出轨贾乃亮选择原谅？原来是因为这个……	agreed
小米汽车要来了！仅售3.9万，网友：相信小米但不信北汽	小米平板被放弃？雷军亲自辟谣！下一代小米平板正在研发	unrelated
家里的蚊子太多？只需地上放上它，蚊子来一只灭一只	家里蚊子太多？地上放点它，一晚上灭一团，夏天见不到一只蚊子	agreed
相恋十周年，难道出现感情危机？谢娜清空张杰微博	谢娜张杰情感破裂？谢娜狂删与张杰秀恩爱的微博	agreed
如何才能怀男孩生男孩的概率更大？揭秘备孕生男孩的秘诀！	关于生男孩的秘诀有不可信的谣言，导致很多人怀不上男宝!	unrelated
冰箱里打死都不能放的6种食物，放进去就得扔，许多主妇却还再犯	打死都不能放冰箱里的6种食物，拿出来就得扔，许多主妇却还再犯	agreed
第四套旧版50元人民币价格一涨再涨！	第五套人民币的豹子号价值上万	unrelated
男子海滩发现一具“外星人”尸体	惊人，原来各国发现这么多种不明飞行物，还在怀疑外星人的存在？	unrelated
宝宝穿开裆裤，后果比你想得更严重！	宝妈图省事，4岁宝宝一年四季穿开裆裤，没想到意外发生了	unrelated
tfboys斩获大奖也难合体，难道真的要解散了？	tfboys要出新歌了，网友们却呼吁赶紧解散为哪般？	unrelated
木瓜靠谱吗？产后丰胸的正确姿势！	辟谣｜谁说「母乳是血变的」？	unrelated
火爆全网的“暴瘦贴”！不节食不运动，25天瘦出小蛮腰！	运动瘦局部？这只是个看上去很美的谣言	unrelated
终于杨蓉也整容了，网友：这是打了二十斤重的玻尿酸吗	37岁杨蓉整容后撞脸张檬，少女脸成网红同款，她有多想不开？	agreed
王菲干预李亚鹏的新恋情,直言不许结婚,新女友发怒:你算老几	王菲干预李亚鹏新恋情，直言不许结婚，新女友发怒：你算老几	agreed
出门身上一堆卡？那是因为你还没打开手机上的这个功能	手机网速跟蜗牛爬一样？那你试试打开这个功能，从此和卡顿说拜拜	unrelated
老公用手机都干嘛了？手机输入4个数字，马上一清二楚	想知道女朋友拿你手机干嘛了，输入这几个数字，就一目了然了！	agreed
早餐很重要，但这5种早餐最伤孩子，还不如不吃！	早餐最重要，送您早餐饼做法大全，营养早餐很重要	unrelated
夏天再热也不能对宝宝做这6件事！	辟谣系列一：夏天给宝宝剃光头会凉快？	unrelated
听说圆通快递要倒闭，顺丰公司要上市？	林心如又怀二胎？霍建华厉害，林志颖会怎么想？	unrelated
新娘要8800下车钱遭新郎暴打？小夫妻：胡说！	静安府、彭浦情？代东区业主发布事实真相澄清一篇～兼听则明！	unrelated
新版人民币亮相了？	玩雪会伤眼睛？1月朋友圈十大谣言出炉！	unrelated
江西潘阳发生驾车恶性撞人事件 致3死11伤	玉溪极中心恶性案件是谣言	unrelated
怀孕期间 教你B超看男女 不看准后悔！	划伤舌头恶化舌癌 ?口腔癌预防大于治疗	unrelated
佟丽娅离婚风波，真正男子汉有毒？	佟丽娅离婚风波未平，二胎传闻再起，这谣言还能再假点吗？	unrelated
支付宝新规：余额宝将不能自由存取！马云：珍惜最后的时间！	余额宝将不能自由存取，这是支付宝新规定，时间不多请珍惜	agreed
双十一购物谨防被骗 红包链接不能乱点	郭冬临晒对比签名辟谣商家虚假宣传：大家别上当	unrelated
花生快速瘦身法，每天吃几颗，3天瘦5斤，排肠毒治便秘！	花生和它一起吃，3天排湿毒治便秘，20天瘦了28斤不反弹	agreed
河南省2018年中考政策出台！8类考生可享受加分！	冒充兰大组织举办自主招生考试培训 官方辟谣	unrelated
白癜风治疗有多难，一瓣大蒜就能治疗	一些白癜风治疗有帮助的食物，你有在坚持吃吗	unrelated
宝宝的长睫毛，原来是孕期比平时多吃了这几样食物（准妈妈选存）	婴儿期剪眼睫毛，睫毛会变长？NO！妈妈们不要听坑娃谣言了！	unrelated
每天喝橙汁,健脑见效快	喝橙汁健脑改善记忆	agreed
大蒜这样用，3天搞定鼻炎，7天根治，不再复发惹人烦，快试试吧	根治鼻炎，一颗大蒜就能治鼻炎，3天就见效，三周断根不复发！	agreed
火腿酸奶同食致癌？闯红灯避抓拍有“绝招”？呵呵！	4月1日新交规 谣言沉渣泛起 做号江湖该收敛了	unrelated
日本又一名企业全面撤资中国，全因中国一举措，网友：好走不送！	这几种食物好吃又美容养颜，女人要想年轻就要常吃，让你皮肤更好	unrelated
农村的村干部应该有哪些人来当？看看国家出台的新规	郑爽恋情曝光了 他抱得美人归 恭喜爽妹子终于觅得良人	unrelated
再见了陆地夫妇，鹿晗公布恋情后，热巴和陈伟霆疑似也好事将近？	鹿晗热巴何时公开恋情 “陆地CP”十大心动瞬间	unrelated
王菲女儿窦靖童宣布出家，20岁就已经看破红尘？	窦靖童看破红尘剃光头要出家？回应：根本就是谣言	disagreed
村民迷信治病种下罂粟苗 红安警方铲除107株	罂粟可以为鸭子治病？男子误信谣言种植罂粟获刑	unrelated
“毒中之王”的蔬菜竟然是它!	毒中之王蔬菜竟是它 空心菜或为榜首	unrelated
2018年社保改革新政策：这四大情况可提前支取养老金	2018年社保改革未来权益新政策，养老金待遇影响因素知否？	unrelated
美国二战时期神秘失踪的轰炸机，1987年却在月球上找到	辟谣！飞机无法降落在揭阳上空转圈？大飞机正常训练！	unrelated
真相报告——手上长倒刺不是因为缺乏维生素，而是	手指长倒刺真的是缺维生素吗，看了这个你就明天了	agreed
成龙车祸死亡现场图片	日本研发出纳米胶囊可杀伤癌细胞	unrelated
价值百万的深圳户口是如何练成的，推荐广大深圳市民阅读	有了深圳户口至少赚180万？2018最新入深户大全…快收藏！	unrelated
清远大学城女生被强行掳走上车	转发节庆图片暗藏钓鱼程序？民警辟谣：只有图片文字无法骗财！	unrelated
早上吃金苹果，晚上吃毒苹果，苹果真不能晚上吃吗？	早上金苹果，中午银苹果，晚上毒苹果”，什么时候吃苹果最好？	unrelated
国内二价宫颈癌疫苗真的是国外淘汰的产品吗？	辟谣｜网传“宫颈癌疫苗致死致残”，吓唬谁呢？	unrelated
红枣泡一泡，每天吃10颗，清除身体癌细胞，一辈子远离癌症！	南京银隆被查封 河北银隆大面积停产 董明珠要发飙了！	unrelated
丈夫前妻回国还住进了自己家里？蒋欣这后妈不好当啊！	蒋欣当后妈教训女儿堪比宫廷争斗戏，句句带刺不留情面！	unrelated
情况通报辟谣	近日，又有谣言散布“葡萄皮上白霜是农药”	unrelated
减肥并不难，每天这样做，轻松减脂瘦身，看一遍就能瘦	卓别林1928年电影中惊现使用手机的妇女	unrelated
喝白开水的好处多多，但是白喝水这样喝却能喝出癌症！	喝白开水不能乱喝，当心喝出癌症（值得收藏）	agreed
惹怒网友，圣诞节马蓉扬言送王宝强绿帽子	当天是圣诞节马蓉再作祟，说要送王宝强一顶绿帽子，惹怒网友	agreed
女儿五岁不会说话，深夜听见婆婆一声大叫，爸爸妈妈立刻往外跑	没查清就说我是”罪犯“的女儿，曾宝仪诅咒谣言诽谤者全家……	unrelated
手机忘记密码，不用去刷机了，自己在家就能开机了	手机忘记锁屏密码？教你轻松2步搞定，不用刷机	agreed
男子网上冒充“西藏公安”散布“偷小孩”谣言被抓	失踪小孩被割肾？蓝山两网民散布谣言被行政拘留	unrelated
继家暴风波后，何洁携子录亲子节目，孩子嚎啕大哭：我要爸爸！	《不可思议的妈妈2》七宝做教育示范 何洁发文斥谣言放大误读	unrelated
竞争最惨烈的公司成全球估值最高的 程维揭秘滴滴背后的核心能力	出租车包围载孕妇滴滴车？官方：与事实不符！谣言！	unrelated
多吃土豆能减肥通便，但这一种土豆千万不能吃，严重则会致死！	缉毒警被折磨致死？公安部辟谣：有些事情不能容忍是有道理的	unrelated
生命线看寿命，生命线预示生命危机，会看的人才能把握命运	生命线竟能看出人的寿命？一招告诉你生命线是咋回事！	agreed
各位车主请注意！明年车要配备反光背心！	车主注意！1月1日起，所有车辆必须配备——反光背心！	agreed
膝盖疼别乱花钱了，菜场上抓把韭菜胜过十副药！快点告诉需要的人	膝盖疼有救了，6根韭菜有奇效，用一个好一个，为家有人转发收藏	agreed
怀孕了想知道是男孩还是女孩，这几种方法可以看出来	怀孕后多用手电筒照肚子，就能让孩子视力变好？你进入了谣言的坑	unrelated
网警辟谣｜微信群传播保定博野“有人偷孩子”系谣言！	镇江家长注意啦，镇江朋友圈流传100多人偷孩子挖器官系谣言	unrelated
李易峰吴昕恋情曝光疑似同居，赵丽颖：关我什么事？	这些细节看出赵丽颖、陈伟霆又爆出恋情了？	unrelated
微信不上传个人真实头像会被锁群	辟谣：网传中国网络监控清理关闭微信群当然是假的	unrelated
独生子女将无法继承父母房产？大家来看看	独生子女不能继承父母全部房产了？	agreed
范冰冰独自逛街 曝李晨范冰冰已领证结婚	李晨输掉千万是谣言！网友爆料范冰冰不想回国是在美筹备婚礼	unrelated
厨房抓一把花椒加上它，前列腺炎一次见效，10天断根	一把花椒，治好了11年的前列腺炎，1天见效，7天断根不复发！	agreed
洗头发加了点这个东西，白发很快自然变黑发，再也不用去染发了	洗头发加点它，白发很快自然变黑，再也不用染发了	agreed
女人早晨吃水果营养最好	早晨吃水果 营养最好	agreed
王凯蒋欣恋情曝光，热聊旁若无人，蒋欣发微博甜死众人	有情人终成眷属！蒋欣王凯宣布恋情，这次是真的，绅士手都没了！	unrelated
网曝一物业提示街头赠送的钥匙扣藏追踪器 警方称未发现此类案件	网传“精美钥匙扣系追踪器”已被证实为谣言	unrelated
杂粮虽好这5类人却不能多吃一口！吃多反而有害健康！	谣言：孩子应该多吃粗粮	unrelated
“还我陶院！”景德镇突发事件，学生集体抗议学校“被卖”	老校区6亿元被卖?景德镇陶瓷大学辟谣：系独立学院改设 已暂停	disagreed
筹码分布选股法，字字有料，背熟6句你也可赚钱	技巧讲解：筹码峰选股技巧 选出逆势上涨的强势股	agreed
自动挡汽车停车后先熄火还是先挂P挡？	停车要先挂N挡，再挂P挡	unrelated
北京、武汉等多城市暂停投放共享单车	北京市消协辟谣：暂未发布共享单车比较实验结果	unrelated
大蒜去皮小妙招，不用手剥不用刀拍，一分钟能去皮一大盘，超实用	辨别地沟油就是这么简单，一个大蒜子，这方法不知道太可惜了	unrelated
大鑊了！研究報告指：Wi-Fi 對BB 影響超預期	手机辐射对孕妇影响大-孕妇减少手机wifi辐射影响的措施	agreed
不吃主食就能减肥？	你还在不吃主食减肥吗？错了！要这样吃着食品减肥	unrelated
林心如女儿“小海豚”真名终曝光，不料霍建华称更爱妈妈？狂撒糖	林心如女儿近照曝光，现在的小海豚长这个样子，难怪一直不公开！	unrelated
涉“南方电网”不实言论及图片视频疯传 广州警方：系捏造	朋友圈传出陕西化工厂闪爆虚假视频 造谣者已被警方带走	unrelated
「特别关注」4月1日起，驾考将有大变化！	4月1日起保费要贵起来？保监局辟谣：引用文件根本两回事	unrelated
今日财讯：新试剂可一滴血测癌症，中国航空公司晚点率居全球第一	劳动节看劳模，科研付出造就一滴血可测癌症	agreed
洋葱疲软的杀手，只花不到5毛钱，两天硬邦邦，吃了都变硬！	洋葱疲软的杀手，只花不到4毛钱，两天硬邦邦，吃了都变硬！	agreed
一心只想嫁富商？“背叛”刘德华多年退出演艺圈，如今终于获原谅	张柏芝和关之琳在梅艳芳葬礼做了啥 以至被骂多年网友还不肯放过	unrelated
网络女主播夜宿故宫视频引关注：单霁翔——如此视频传播伤害故宫	“夜宿故宫”女主播含泪道歉 3D揭营收200亿直播乱象	agreed
无证驾驶摩托车 八人被行政拘留	溧水摩托无证驾驶要拘留	unrelated
胖一个夏天是怎么样的体验？丢你“负卡路里食物”，只能帮这了	肚子赘肉多，腰粗肥壮？每天吃点负卡路里食物，45天“小一号”	agreed
打蜡苹果真的致癌吗？	农村的这种杂草，可治疗痛经、活血化瘀，女人的家里都备点	unrelated
口臭严重竟说明肝有问题！快吃这些食物为肝脏“解解毒”	夏天多吃丝瓜这个菜，消暑解毒，还保护肝脏健康	unrelated
文章骂儿子，夺门而出，文章：“反了！谁是爹，谁是儿子啊？”	2018即将面临30年来最大失业潮，倒闭潮的危机！震撼73	unrelated
江疏影带张嘉译参加同学聚会，炫富模式开启	江疏影带张嘉译参加同学聚会，炫富模式开启！	agreed
光天化日之下抢小孩 20180523	太猖狂！监控实拍光天化日之下抢小孩，家里有孩子的一定要注意了	unrelated
岳云鹏和儿子不用做亲子鉴定	带孩子做亲子鉴定的五位男星，谢霆锋可以理解，汪峰“不自信”？	unrelated
内蒙古锡盟东乌旗发生地壳推移，俗称走山	锡林浩特市东乌旗发生地壳挪移变迁	agreed
《安利全集2》晚上运动等于慢性自杀？微信：FC54116	晚上运动等于慢性自杀？微信：109388230	agreed
范冰冰弟弟近照曝光，网友：洪金宝儿子真心帅？！	李晨范冰冰下月在北京举行婚礼？	unrelated
世界上最“缺”男人的三个国家，成堆美女愁嫁，你喜欢哪一个？	糖尿病病友们要嘴下留心，这些小食材才是高血糖的“克星”	unrelated
农村老大爷教你一招，家里苍蝇来一只灭一只，再也不受苍蝇的干扰	小姐姐教你一招，家里苍蝇来一只灭一只，再也不受苍蝇干扰！	agreed
以史为证日本如果不被赶走，将是中国的第57个民族	中国第57个民族竟然藏在宜宾？99%的人都不知道……	unrelated
知情人爆白百何陈羽凡分居未办离婚手续！《人民》导演不拍续集？	离婚后白百何衣品乡土味，陈羽凡看到之后不知怎么想？	unrelated
社保新消息！这部分人医保个人账户又涨钱了！真实惠！	医保账户里的钱10月就能取了 ，这些事天津居民得提前做！	unrelated
年度最搞笑！南宁一高校冬训中暑3人	南宁一高校冬训，结果三名学生中暑	agreed
农村房屋“限高令”，超过这个高度的农房要处罚，严重可能要坐牢	农村房屋“限高令”一出，超过规定高度，要做好准备了	unrelated
上海松江城管强拆民房，打工者何去何从	城管打人致死	unrelated
皮皮虾“注胶”只是虾黄虾膏 吃货们不要担心	网传皮皮虾被人为注胶增重 专家辟谣：那是虾黄虾膏	unrelated
发芽的土豆千万不要吃,还有这些也是	生活妙招 发芽的土豆不能吃，但是用途也很大	unrelated
晨起第一杯水这样喝延寿20年，大肚腩还小了排肠毒治便秘！	谣言：喝水的最佳时间，多喝不如不喝	unrelated
肾乃百病之源，花椒加点它，一次见效，10天永不复发！	肾乃百病之源，一把花椒加上它，2次就见效，7天不复发	agreed
农村这4项补贴属农民所有，谁阻拦不发谁就摊上事了！	火箭少女合力破谣言，美岐接二连三摊上事，最开心的要属杨超越了	unrelated
晚上入睡难，用这个失眠方法，让你一觉到天亮	谣言：失眠的后果很严重	unrelated
吃蟾蜍可治皮肤病，甚至癌症？	杜海涛自爆想当爸爸后、与女友一起录节目，沈梦辰撞脸4千年美女	unrelated
杨钰莹终于要结婚了，老公是有名的星二代，希望她们能幸福	45岁杨钰莹终于要结婚了，两人早已领证，新郎竟是有名的星二代	agreed
惊呆！大学生娶同学妈妈 年龄相差34岁	大学生娶同学妈妈 年龄相差三十四岁！	agreed
手机如何不root就能查看已连WiFi密码？	一招查看WiFi万能钥匙破解的WiFi密码？	agreed
不吃晚饭是乱减肥，健康饮食才是硬道理	不吃晚饭能减肥吗？不吃晚饭有害身体健康	agreed
沐浴乳含有的paraben使用十年恐诱发乳癌	奇闻异事：揭秘不明飞行物目击事件之男子坐车跟拍巨大UFO航母	unrelated
农村新政策出台，这些农民将面临巨额罚款，这些农民却有补贴拿！	农村新政策出台，这些农民要缴纳罚款，这些农民能领到补贴了	agreed
健十教你如何预防和改善高血压问题	高血压该如何科学饮食？有预防高血压作用的蔬果	agreed
大蒜和白酒这样吃，比19岁还凶，三天老婆更爱你，比牛鞭还补	大蒜和白酒这样喝，比19岁还凶，三天老婆更爱你，比鹿鞭还补！	agreed
明察｜四川宜宾警方：“枪击爆头视频”是拍电影，非枪击案	辟谣！网传“宜宾东街一男子疑似偷小孩被抓”情况不属实	unrelated
白百何发文“hi，你来了”疑怀二胎，医馆调理身体获神秘男陪伴	白百何疑似怀二胎，小腹微微隆起跟陈羽凡一起现身机场！	agreed
生姜擦头皮可生发 一天几次能有效？	辟谣！生姜真的能生发吗？	unrelated
手机掉水里？这样做1分钟正常开机！	手机进水不要慌教你正确处理手机进水	agreed
腰间盘突出不花一分钱，一块仙人掌轻松去根不复发，治一个好一个	腰痛，腰间盘突出，不用手术吃药，一块仙人掌一块姜 轻松治断根	agreed
喝可乐等于慢性自杀？其实我们都被骗了！	隔夜茶喝了会致癌？可乐会杀精？谣言	unrelated
终于讲到祛痘的问题了！DIY芦荟蜂蜜面膜（美白，祛痘）	自制芦荟蜂蜜面膜 坚持睡前抹脸 美白祛痘绝对有效	agreed
乐视会因负面消息而退市吗？	乐视老板娘辟谣“贾跃亭海外信托”，称顾颖琼博士有组织有预谋	unrelated
惊呆！大学生娶同学妈妈 年龄相差34岁	大学生娶同学妈妈 河南21岁小伙恋上55岁中年大妈	agreed
宁泽涛拒绝退役，欲离队单飞，上演王者归来！	宁泽涛重返国家队？相关人辟谣：仍在海军队训练	unrelated
深圳钉子户拆迁获赔1.3亿？中介被抓？	河北警方：晋州“黑水”浇地为谣言 编造地下水污染者被拘	unrelated
南京苏宁球迷上吊自杀	临沂春节期间气温-20℃？-18℃？网警辟谣	unrelated
iPhone Xplus曝光？和iPhone X有什么区别？	iPhoneX Plus信息全曝光！性能逆天，价格有惊喜！	agreed
“夫妻癌、兄弟癌”，癌症真的会传染吗？	你知道吗，这些癌症会“传染”？每年200万人因此不幸患癌	unrelated
穷人的机会来临，2018抓住这三大行业傻子都能赚钱	穷人的机会来了，2018抓住这五大行业，傻子都能赚钱！27	agreed
相声演员曹云金豪宅曝光，光冰箱就有五个，有钱就是任性	曹云金豪宅内景曝光	agreed
想要胎宝宝皮肤白，睫毛长，视力好，准妈妈们努力这样吃！	多吃水果就是对胎宝宝好？准妈妈都被这些谣言坑惨了！	unrelated
刘强东下令，用头等舱空运阳澄湖大闸蟹过来，请员工免费吃	刘强东下令，请员工免费吃！用头等舱空运阳澄湖大闸蟹过来	agreed
什么样的手机号能发财？（数字与命运）——连写第14篇	什么样的手机号能发财？（数字与命运）——连写第13篇	agreed
它是公认的乙肝克星，每天喝一杯，保肝护肝更健康	农村常见中草药，乙肝病毒的克星	unrelated
草莓竟成最“脏”水果？这让爱吃草莓的朋友们怎么活！	草莓最“脏”？流眼泪能排出毒素？这些谣言你中招了吗	unrelated
网传西瓜和桃子同时吃会致命？网友以身试毒，结果……有点撑	科学辟谣——水果越酸VC含量越多？	unrelated
九月起农村这五项费用全取消，农民能得到多少实惠	农民工注意：9月1号起农村3项费用取消，农民省大钱了！	agreed
睡前来点白酒，解决像怀孕的大肚子，一用一个瘦，瘦到停不下来！	肚子大得像怀孕？睡前来点白酒，一用一个瘦，瘦到你想胖！	agreed
网传“峡山火灾烧死多人”事情真相是这样子的~	网络造谣赣榆发生一起车祸 男子被行政拘留！	unrelated
王大治前妻爆料董洁插足她和王大治的婚姻，我的天，董洁的品味	王大治老婆发文怒撕董洁，实锤太多人设崩塌，网友评论三观尽毁！	agreed
奇闻:黄金鱼身体含24克拉纯金	台湾海域发现“24克拉纯金”的黄金鱼	unrelated
娃娃菜蘸了甲醛防腐，会致癌 还能不能好好吃菜了！	「辟谣」火锅煮久了会让人中毒？这些谣言你还在信吗？	unrelated
别小看这张贰圆纸币，价格涨了十几倍，都说它是币王车工的接班人	1990年50元纸币值多少钱第四套人民币50元价格烦翻4倍	unrelated
你还在犹豫要不要收藏第四套人民币吗？现在的价格已翻涨多倍！	第四套人民币价格暴涨，要不要收藏？	agreed
网传广西理科第一名709分奖金100万	去年教师节合肥朋友圈疯转的送礼谣言，你们还记得吗？	unrelated
只需每天饭后一杯“刮油水”，大肚腩消失，体重瘦回两位数	陈坤微博称“董洁是我的”，网友：我们早就知道了！	unrelated
孩子得白血病的症状有哪些	九成白血病患儿家庭半年内装修过？又双叒叕要辟谣了！	unrelated
农村金融天才受邀央视财经：仅靠此“炒股口诀”迎得61次掌声	农村金融天才受邀央视财经：仅靠此“炒股口诀”迎得64次掌声	agreed
最缺男人的国家，美女泛滥！堪称现实中的“女儿国”！	全球最缺男人的国家	agreed
明年起，农民不用补交也能拿近千元了！农村的养老保障终于来了！	西瓜也分公母，看这个地方保熟，秒变挑瓜高手	unrelated
如果爆发丧尸病毒，该怎样活下来？	今晚津京冀地区8点到凌晨6点有间接性地震为谣言	unrelated
中国高铁每年亏损！连银行利息都还不起 美国坦言：无法理解	谣言！中国高铁大半都在亏钱，仍在硬着头皮建新的？	unrelated
农村养老金一次性补缴15年，农民到底能够拿到多少钱？	辟谣！六安老师一次性补发9万元！多方证实，这是谣言！	unrelated
农民要注意！这几种人的农业补贴将被永久取消，看看有你吗？	2018年，这几类农民将被取消农业补贴和扶贫补贴！	unrelated
北京又上演现实版“寂静岭”，谁才是雾霾背后的罪魁祸首？	争议“湿法脱硫”：谁是造成雾霾的“罪魁祸首”？	unrelated
李嘉诚没有彻底退出房地产，万达为什么要宣布彻底退出？	最近王健林为什么要宣布万达退出房地产, 难道房子不赚钱了吗？	unrelated
腰间盘突出不花钱，一把艾叶艾草轻松搞定，1次见效，3天断根！	方法公开：一把艾草加醋热敷，7年腰椎间盘突出3天见效！不复发	unrelated
确定了！《微微一笑很倾城2》女主不是郑爽，而是她	泡脚水里丢一小把它，能够逼出20年湿毒！腰细了，肚子也平了！	unrelated
歌坛又一歌后患癌病逝，留下这首千古绝唱，葬礼上韩红悲痛抹泪	农村男孩突然变成了狼娃，偷吃家里活的鸡鸭，晚上喜欢跑到山上	unrelated
网传重庆观音桥又起火系谣言	网传“当阳玻璃厂落雪砸到一个小孩”系谣言！	unrelated
珍品赏析——广东省造光绪元宝双龙寿字币	湖北官钱局｜光绪元宝湖北省造（铜币），精品赏析	unrelated
林丹事件的背后隐情逐渐浮出水面，谢杏芳首谈原谅林丹出轨原因	谢杏芳上节目晒儿子视频 并首度详谈自己原谅林丹的原因	agreed
网爆王思聪谈门当户对追求马化腾女儿，网友：换口味啦？	马化腾独生女被王思聪表白？纯属谣言！马哥表示严查到底！	unrelated
白发变黑发很简单，只要用淘米水加它，不用再去染发	不管多凶的白发，淘米水加它这样洗，8分钟都变黑，一世不染发	agreed
别再尝试登月了，物理学家霍金警告，月球背面都是外星人	辟谣：霍金曾警告月球背面有外星人！	unrelated
养老金上调最新消息：满洲里市2016年养老金已经调整到位	老人领养老金与子女参保缴费挂钩？市人社局提醒这是谣言！	unrelated
减肥并不难，这样做，刮油排毒，肚子上的赘肉扫光光	173斤减到93斤，坚持每晚一杯，刮油排毒，帮你迅速减重	unrelated
微信公众号怎么拉黑粉丝？	别转啦：微信疯传“多少人拉黑你”是假的	unrelated
毛孔粗大皮肤就特粗糙，一招坚持28天做个白美人	婆婆自觉皮肤好又年轻，取笑儿媳妇是黄脸婆毛孔粗大，不保养自己	unrelated
王鸥“小三“传闻现身 称没有的事 问心无愧	李小璐认错回头，遭贾乃亮无视，而贾乃亮却给“小三”王鸥公主抱	unrelated
冰箱里打死都不能放的6种食物，拿出来就得扔，大多主妇却还再犯	打死都不能放冰箱里的6种食物，拿出来就得扔，许多主妇却还再犯	agreed
岛国奇葩“黑鸡蛋”，吃了能增加人的寿命，一般人买不起	女人吃鸡蛋并非“多多益善”	unrelated
曾是邓丽君接班人，以一曲红过那英，不听话被封杀，50岁还单身	骂完刀郎那英后悔了，险些被王校长封杀，隐藏多年的秘密也被曝光	unrelated
懒人21天快速减肥法 轻松甩肉?减肥?不反弹	晚上不吃饭能清理体内垃圾？更年期女人必须清楚的晚餐4大谣言！	unrelated
根据动物行为可以预测地震	科学家记录地震前动物行为确认动物可预测地震	agreed
可怕!央视曝光:这种纸巾,或致儿童白血病。	魔法之吻提醒您劣质纸巾极可能是造成儿童患白血病的原因之一	agreed
想要儿女双全？三种方法，教你如愿生男生女	重大发现 真的可以决定生男生女 这次我们不说迷信只讲科学	agreed
刘明炜高考准考证丢失	网传“刘明炜”的高考准考证丢了？是谣言！	disagreed
UFO最真实的视频现场！外星人真的存在吗？	蜂蜜加它快速减肥，十天小肚腩没了，闺蜜还以为我去整容了，哈哈	unrelated
恐怖！男子在野外遭到恶灵攻击，吓着我都不敢去了	男子声称野外发现“狼人小孩”，事情越传越邪乎，不得已澄清真相	unrelated
《小李飞刀》风华绝代林诗音，陷整容传闻，与赵雅芝同框不忍直视	62岁婆婆为初恋想成26岁赵雅芝，花费200万整容，成了这样	unrelated
4月29日定远隧道车祸引发爆炸	把生姜贴在肚脐上，奇迹发生了，7天瘦3斤，永远告别便秘	unrelated
卡佩罗已经向江苏苏宁请辞，中超外教失宠土帅将逆袭？	本报独家辟谣意媒！卡佩罗稳留苏宁	unrelated
脸长斑，老专家给你一杯‘茶’轻松去除色斑黄褐斑，美白又养颜	中医专家巧献妙方，解决面子问题，美白养颜又祛斑效果看得见	unrelated
王思聪碰上赵薇也要礼让三分，他却敢当众打赵薇耳光，这人是谁？	热水泡脚还有这些危害？赶快看看，别再误伤自己！	unrelated
冰箱里打死都不能放的4种食物，拿出来就得扔，吃了等于慢性自杀	万万不能在冰箱存放的3种食物！对身体特不好！你家中招了吗？	agreed
云南建水城管对小贩拳打脚踢？实为张冠李戴	海口渔家乐偷排污水致“连理枝”死亡？环保等部门核实辟谣	unrelated
女朋友视角下的易烊千玺实在撩人，不多，我也只看了99遍而已！	明星亲子装大PK，我最服李小璐！昆凌二胎是男孩	unrelated
农村养老保险可以一次性补缴？东阳市农保处这样告诉你	梧州网警辟谣：被征地农民可办理养老保险一次性补缴？	unrelated
奶茶导致男人不孕不育的原因 奶精才是真杀手	奶茶喝多为何致男性不育？动画揭奶茶界潜规则	agreed
恐怖分子要去青岛放炸弹？五网民传播虚假恐怖信息被刑拘	编造“钱宝网”非法集资案件谣言，8名网民被警方行政拘留！	unrelated
相恋十周年，难道出现感情危机？谢娜清空张杰微博	张杰谢娜感情风波后，首次合体为他送祝福	unrelated
吹啤酒的借口来了，研究发现喝啤酒有助于提高记忆力	这汤要常喝，护心脏延缓衰老提高记忆力吸收好，特别是男士请多喝	unrelated
张翰出现新恋情？微博称“丫头，就是你了”	新恋情？张翰和张钧甯假戏真做？这一举动就能看出	agreed
李沁夏日清新沁人心脾，李沁疑似恋情曝光，真的不是邓伦啊	李沁魏大勋疑似公开恋情，邓论含泪送祝福	agreed
手指长短决定财富：这些手指太短不是吉兆，预示难发财！	手指长短可决定寿命长短	unrelated
农民挖祖坟，竟挖出“土地龙”圣物一克竟值千万，专家看傻眼了！	挖隧道挖出地下暗河 隧道逆流成河	unrelated
秦始皇苦苦寻觅的长生不老药，2015年被一农民无意中捡到	古天乐郭采洁坐实“恋情”? 网友再次表示汪峰好可怜	unrelated
夏天晒黑了怎么快速美白？天然小妙招 让你雪白玉肌亮出来	很多人不知道，淘米水是个宝，竟能够快速祛斑美白，斑点全无	unrelated
大蒜灭蚊比蚊香有效，安全又无毒，这个夏季家中一只蚊子都没有	灭蚊不用再买蚊香了，几瓣大蒜就能搞定了，效果比蚊香还管用	agreed
肉肉太多不用愁，一根香蕉，4天刮去7斤油，22天瘦了28斤	吃香蕉会发胖么？朋友每天吃三根，一个月后身体竟变成这样！	unrelated
据说柠檬水可以美白，真的吗？	「当当老师来辟谣」但凡美白产品都含有铅汞？NO！	unrelated
前夫无耻不要脸求复婚，姑娘爆出凄惨经历，涂磊怒骂：阴险的小人	涂磊：活该你是被你前夫抛弃，你就是狼心狗肺！	unrelated
猴年尾声“猴宝宝”扎堆出生 月嫂薪酬过万	猴年遇上二胎，兰州月嫂居然这么抢手！	unrelated
4亿年前有机械物体	4亿年前外星人制造的机械装置在俄国被发现	unrelated
安阳公共自行车车桩雨后漏电	车桩雨天电人为谣言 公共自行车桩电压仅14伏	unrelated
潭下三名未成年人在公平乡被绑架	不起眼的它是天然补肾食品, 每天吃一点, 补肾壮阳气血两旺	unrelated
刘德华，退出演艺圈，网友讨论鹿晗，黄晓明谁能接班？	张柏芝在梅艳芳的葬礼上做了什么？被后人痛骂	unrelated
杨蓉步张檬后尘，也整容失败了，满脸玻尿酸苹果肌好夸张	《钟馗捉妖记》播放量破2亿，杨蓉频繁晒素颜力破整容谣言	unrelated
航空路菜场今天查到病牛肉？谣言！	航空路菜场今天查到病牛肉？谣言！	unrelated
疱疹性咽峡炎来袭！孩子如何才能避开它？	孩子得了疱疹性咽峡炎，怎么进行家庭护理？	agreed
电力专家醉酒说漏嘴：插座放一‘物’,一年电费能省1000元！	供电局表姐偷偷告诉我：插座放一“宝贝”，一年居然能省上千电费	agreed
新房甲醛超标很严重？甲醛最怕的2个土方法，一周就可以住新家	甲醛清除剂可以一次性清除甲醛？十种方法，九种谣言	unrelated
感冒捂被窝出汗好吗？感冒后这些事情千万不要做	曹云金郭德纲撕逼后豪宅首曝光 邵沛设计“笑看风云”一语三关	unrelated
《前半生2》女主不是马伊琍，另换其人？	食物两两相克 切记这几样不要一起吃	unrelated
湿气“死对头”，早上吃一点，湿气就能一扫而光，大肚腩也下去了	湿气“死对头”，早上吃一点，湿气就能干干净净，大肚腩也变没了	agreed
业主们注意！这8种情况可拒缴物业费啦！还可能“领红包”	物业：这些情形业主可拒缴物业费！还有不少钱可向物业要	agreed
小东西大作用，每天洗脸加一点点，让你皮肤更加有弹性	春天洗脸的正确方法，女士喜甜男士爱盐，让皮肤一天天白起来	unrelated
看一眼就得红眼病？医生：纯属谣言	子虚乌有！打脸BBC 伊朗封杀《部落冲突》纯属谣言！	unrelated
生活小妙招-鱼刺卡喉咙一招搞定	鱼刺卡到喉咙别再喝白醋了，教你一个非常实用的方法，轻松搞定	agreed
娱乐圈十大最爱国的明星：姚明拒绝代言，最后一位霸气又给力	姚明被赞当年拒签丰田1.6亿代言合同，为何女儿却入美国国籍？	unrelated
手机一格电，辐射1000倍？	可怕！手机快没电时打电话，辐射竟会猛增千倍？	agreed
公公强吻儿媳后两家人现场斗殴？现场视频系张冠李戴	因18万彩礼，潍坊母女跳楼？警方出面辟谣	unrelated
网传飞机撒药治白蛾 乌鲁木齐园林部门回应：假消息	旧谣新传！飞机撒药治白蛾 泉州园林微博再次辟谣	unrelated
狗狗生下一人形怪物，这到底怎么了？	在一个贫困的小山村，狗狗生下一人形怪物，这究竟是什么回事？	agreed
三天暴瘦十斤！！！	三天暴瘦十斤的秘密	agreed
桃子也分公母，公桃更甜，看准这个地方，包你挑的个个都是公桃子	桃子难分公母，公桃子更甜更好吃，教你一招，个个都是公桃子	agreed
白头发越来越多，洗头时加点它，白发自然变黑发	白头发不要染，洗头水里加这几物，头发自然变黑，从此不要染发！	agreed
服用灵芝孢子粉治疗多种疾病	灵芝孢子粉 提高免疫力 治疗癌症等各种疾病	agreed
万万没想到，这些蔬菜可以防癌抗癌	3种防癌抗癌的保健蔬菜，特别是莴苣还能防治便秘！	agreed
网络女主播夜宿故宫视频引关注：单霁翔——如此视频传播伤害故宫	女主播自称夜宿故宫直播慈禧床榻 盘点那些奇葩直播	agreed
丈母娘上门谈判李小璐离婚，贾乃亮母亲彻底撕破脸皮	李小璐、贾乃亮离婚前夕才发现自己怀了二胎	unrelated
关晓彤表白李易峰被拒后，更会搭配了，一起跟她学习青春叛逆搭配	关晓彤表白李易峰被拒绝，如今亲密合作能否擦出火花？	agreed
美国宇航员在月球上发现巨型外星人飞船和大量尸体	美国宇航员在月球上发现巨型外星人飞船和大量尸体，回国后被禁言	agreed
秦俊杰袁冰妍举止亲密	经常熬夜最伤肝脏，这3种食物要多吃，减少肝脏损伤抗疲劳！	unrelated
可怕的不是拉丁舞导致性早熟！诱发性早熟的真凶是它！	"网上热传""女孩跳拉丁舞会导致性早熟"" 医生辟谣！"	disagreed
U23亚洲杯空场已达6场！亚足联连发三微博向中国球迷示好	韩媒辟谣：没求中国阻击乌兹别克斯坦！中国队自求多福吧	unrelated
经常在外偷人的女人逃不了这四个表现	女人，偷过人后的8个表现，最后一个很准！	agreed
咳嗽不用止咳药，只此一招，便能去根！	任何咳嗽，不用止咳药，只此一招，便能去根（值得一试）	agreed
汕头5月1日后房产限购限贷	九成家庭都在使用的这种筷子，可能含一级致癌物！看完赶紧扔了吧	unrelated
会计从业资格证是真的取消了吗？为什么？	辟谣｜NAATI报考事宜将一切正常，并无取消之说，大家请放心	unrelated
孕妈除了吃核桃补脑，这3种食物也是补脑佳品！而且都很便宜！	喝六个核桃补补脑	unrelated
2018年互联网暴利创业项目，选对创业项目赚钱只是一个数据	今日头条产品负责人：抖音独立融资为谣言	unrelated
秋季减肥从饮食入手 一天多瘦一斤	警惕！晚睡可能会导致不孕不育 晚睡带来的危害非常大	unrelated
刘涛首度公开王珂破产后提出离婚的真正原因 真让人心疼	刘涛首谈老公王珂要和她离婚的内幕，心疼她！	agreed
成都太古里一男子跳楼身亡？又是移花接木的谣言	小寨有人跳楼？西安网警：系谣言 已口头警告	unrelated
农业户口将取消，农民要拿到这2个证，未来价值顶套房	农民注意：赶紧去办这2个证，起码价值20万，错过吃大亏	agreed
产妇坐月子不能吃盐？吃盐奶水少？专家教您科学坐月子！	「谣言粉碎机」坐月子哭眼睛会瞎？妈咪产后用眼别太任性	unrelated
「今日推荐」好消息！2018年农村这3项补贴直补到户！	2018农村最新粮食补贴及发放时间	unrelated
剩饭剩菜会致癌？这4种剩菜千万不能留！赶紧告诉爸妈……	吃剩饭剩菜有毒致癌？营养师：不要再无知了！用数据告诉你真相！	disagreed
对话旅行の青蛙：火爆背后隐藏是测试使用者的生育意愿？	旅行青蛙竟是一款生育意愿测试器？	agreed
保真“古钱币”交易中深受藏家喜爱，2017古钱币近期行情公布	2017古钱币最近市场价格以及最近行情分析	agreed
只因18万彩礼要去母女生命！	母女因彩礼跳楼？都是谣言！	unrelated
微信不上传个人真实头像会被锁群？桂林网警回应	网警辟谣 网传南京苏宁球迷上吊自杀？谣言	unrelated
小苏打加它洗头，再凶的白发，3分钟转黑，一生不染发！	茶叶加它洗头，不管多凶的白发，一分钟黑如煤炭，一世不染！	unrelated
上海移动手机用户13日起未实名将被停机？实际情况是……	景甜方辟谣！表示登记结婚信息不属实，因拍戏没时间婚期未确定！	unrelated
博白至水鸣路段出现老虎？真相在这里！	网传“老虎吃人视频是病毒”为谣言 请理性对待！	unrelated
俄第五代战机被命名为苏-57 将于明年开始列装	军事：俄第五代战机正式获名苏-57	agreed
现在的100万，10年后相当于多少钱？	现在的100万元，10年后值多少钱？	agreed
能不能长寿看身体这几个指数，7大尺寸决定寿命长短的	人体七大尺寸决定寿命长短	agreed
早上喝一勺，30天净化血管，堵塞地方全部通了，整个人神清气爽	早上喝一勺，30天净化血管，堵塞地方全通了！	agreed
如果早期想躲过糖尿病肾病的症状，这几样饮食绝对不能吃	糖尿病患者不能吃水果？医生说：这个时间段吃了根本不影响血糖！	unrelated
微信和支付宝这两个功能赶紧关闭，不然银行卡搬空！	支付宝要关闭刷银行卡的功能？从来没有的事！谣言啊。。	unrelated
农民注意了，农村这些人的户口会被注销，土地也会被收回！	辟谣：出国定居人员无需注销户口！绿卡、永住都安全	unrelated
竹子是树还是草？你见过竹子开花吗？	农村流传“竹子开花，就要搬家”，背后的秘密是这样！	unrelated
潭下三名未成年人在公平乡被绑架	还在认为吃腰子补肾吗？看看吧，再吃就真的废了	unrelated
疑似魅族Flyme7系统曝光：2月24日发布	2月24号，你们的Flyme7就要来了！	agreed
博白至水鸣路段出现老虎？真相在这里！	网警辟谣：关于“汪清近期发现多个拐卖小孩案件”系谣言	unrelated
白头发多？洗头加点它，4天白发变黑发，不用在染发啦	白头发不用染，生姜切碎加它这样洗头，3天白发变黑。告别染发	unrelated
最高补贴1万8！驻马店农村户口进城购房还能再享优惠政策！	沈阳契税大厅辟谣：个人购买首套、二套住房契税政策未变	unrelated
市售荔枝多为毒药水浸泡？孩子吃荔枝得手足口病？荔枝还能吃吗？	「网警辟谣」不法商贩用硫酸和乙烯浸泡荔枝？这是真的吗？	unrelated
立秋后是儿童长个的活跃期，每天给孩子吃点它，个头猛窜	立秋是儿童长高的黄金期，每天吃这些食物，让孩子个头蹿一蹿	agreed
中医祖传秘方，奶奶才用了3天了，白发真的变黑了，不用花钱染发	中医祖传秘方，奶奶才用了3天，白发真的变黑了，不用花钱染发了	agreed
世界上战斗力最强的8支军队，哪个国家最骁勇善战？	太厉害了！史上战斗力最强大的军队排行榜！	unrelated
电水壶坏了，千万不要扔，告诉大家个小秘密	电水壶坏了不要扔，告诉大家一个小秘密！	agreed
茄子和蘑菇一起吃会中毒？有的人已经“中毒”没救了	「辟谣」微信群中传播的所谓“九不准”是谣言！	unrelated
大衣哥朱之文突然发文宣布退出娱乐圈？	朱之文妻子要求大衣哥退出娱乐圈 看看他的儿女现在都成啥样了	unrelated
徐峥新作《印囧》来袭，王宝强、黄渤回归，网友：这次终于没有他	《印囧》即将到来，看这演员阵容，又是部票房口碑双手的电影吗？	unrelated
满头白发别去买染发剂，淘米水加个它，白发很快就变黑了	白发变黑只用这么做，淘米水加他洗三天，强根固发，白发变黑了！	agreed
喝白开水的好处多多，但是白喝水这样喝却能喝出癌症！	每天喝白开水不能乱喝，当心喝出癌症！快告诉你的家人们	agreed
网络热传“清明甘蔗比毒蛇还毒”，到底怎么回事？	“清明蔗毒过蛇！”清明将至，这种红心甘蔗千万别吃……	agreed
娃娃菜蘸了甲醛防腐，会致癌 还能不能好好吃菜了！	柠檬酸泡莲藕会致癌？谣言！	unrelated
女宝宝四岁还不会说话，从幼儿园回来走路怪异，妈妈检查后大哭	宝宝四岁上幼儿园最好？你从哪里听来的谣言！	unrelated
不会再有农民工了，好消息！农村人的身价将倍增！	不会再有农民工了！农村人的身价将倍增	agreed
盘点世界十大不明生物，神秘不明怪物突袭人类	实拍5大神秘不明生物，日本海啸拍到怪物！	agreed
喝茶减肥的八大禁忌	喝茶真的能刮油吗？哪些茶可以减肥	unrelated
男朋友好心给李沁送鸡汤，说怀孕要补身体，不料里面下了堕胎药！	心机婊怀孕被抛弃，找豪门千金李沁帮助，决定要报复	unrelated
白发变黑发小妙招	白发变黑发妙招揭秘！和你分享科学方法！	agreed
严惩！30多人被查实，五人被拘，网络造谣传谣者戒！	“宜章县五人感染SK5病毒死亡”谣言者被执行行政拘留三日处罚	unrelated
刚传出刘亦菲怀孕，宋承宪就宣布分手，还说出这话，真是渣透了！	韩国综艺节目曝刘亦菲已怀孕？有望与宋承宪年内结婚？	unrelated
权威辟谣！疯传的“太原限购”是假的！请勿传谣！	增城从化要限贷？传言不实 调查：四成网友暂放弃买房	unrelated
17天治疗高血压！高血压最怕它，喝水加它清血脂，治愈高血压	独家揭秘 古钱币 光绪元宝 奉天省造 银元铜币	unrelated
微信悄悄出新功能！网友：千万不能让女友知道！	微信悄悄出新功能！网友：千万不能让女友老婆知道！	agreed
揭秘“市面上八成玫瑰干花被硫磺熏过”	“你喝的不是茶，而是毒药”？请让谣言终止于你的朋友圈！	unrelated
不知道怎么出手古钱币可以阅读收藏一下这篇文章！	出手古钱币，专家鉴定！	unrelated
脚痒难耐、臭气熏天？八个偏方，告别脚气，再也不怕炎热夏天	熊乃瑾首度回应与王宝强恋情 婚纱照原来是这样拍的	unrelated
刘恺威老婆杨幂同班同学袁姗姗首次上节目回应整容像杨幂内幕	整容、曝艳照、抱王凯大腿！刘恺威怎么出轨了这么一个女人？	unrelated
灭蚊别在用蚊香，只要3颗大蒜，一只蚊子都不敢进你家门！	大蒜灭蚊比蚊香还管用，不用买蚊香，整个夏天一只蚊子都没有	agreed
“没有金主”的辛芷蕾，还能火吗？	辛芷蕾霸气辟谣没抢景甜“金主”，却秒删发文，到底怎么回事？	unrelated
日本气象厅：福岛1122地震系日本311大地震余震	河北永清余震：如何有效辨别谣言？	unrelated
暴雨后自来水会浊两三天	李亚鹏于许晴公布恋情了，王菲第一时间祝福，网友：一切重归于好	unrelated
终于找到洗葡萄最干净的方法，残留农药去光光，还能消菌！	葡萄用水冲，相当于没洗，教你一招，残留农药全洗掉，干净又卫生	agreed
网传王者荣耀团队年终奖100个月工资 腾讯游戏回应：太离谱	腾讯即将开始封群？官方回应：此消息为子虚乌有	unrelated
男子闯入巨人国，被当成小白鼠做实验，一开口讲话巨人都蒙圈了	两外国男子酒吧欺负姑娘，小伙把刀一亮出来，就把两男子吓跑	unrelated
卡帅痴心不改！意媒：广州恒大欲签卡利尼奇	卡利尼奇去马竞体检？迪马辟谣	unrelated
多次被传怀孕女星盘点，王菲范冰冰谢娜等中招	谢娜微博晒新年照没吴昕疑不合 工作室辟谣	unrelated
孕期有这些特征，生男孩的几率实在太大了	孕妇生男孩的8个身体特征	agreed
2017生男生女最新清宫图计算法，据说很准！	2018清宫表生男生女如何计算，清宫表是根据什么算？	agreed
人类为什么没有再次登月？是被月球上的外星人“吓”到了吗？	外星人现身月球？有“坦克”为证，传说难道是真的？	unrelated
李易峰秘密相爱八年，公开恋情的女友居然是她？	李易峰自发深情微博要公开恋情？	agreed
用它煮水喝，无论什么咳嗽，一天断根！速存~	不管咳多久，把它煮一煮，娃娃喝了，咳嗽马上断根！速转！	agreed
手机来电不想接，又不好意思挂断？教你一招，手机可以变空号	手机来电不想接，只要打开手机这个功能，让你的手机立马变空号	agreed
揭秘洪秀全后裔真实去向，逃至日本随军侵略，还主动认祖归宗！	西瓜甜不甜，看这个地方就知道了，其实西瓜也是分公母的！	unrelated
挖掘关羽墓曝光，沉睡两千年的青龙偃月刀终于出土了	4S店实拍，起亚这款上市车型，丐版售价不到5万	unrelated
2018新条例实施，这8种情况下，业主可以拒缴物业费！	新规出台，这8种情况可拒缴物业费	agreed
“电子警察”的工作原理,“闯红灯”原来是这样被拍的!	熟悉电子警察拍照原理,新手驾车 前轮过线千万别再退回	unrelated
公务员级别工资等级标准出炉，看看你的级别工资是多少？	「关注」最新公务员工资等级标准表来了！	agreed
丈夫前妻回国还住进了自己家里？蒋欣这后妈不好当啊！	后妈蒋欣与女儿强势斗嘴火力全开，三寸不烂之舌气哭对方！高清	unrelated
别浪费钱去洗牙了！给你支招几个土方法，美白牙齿更去除口臭	洗牙加美白牙齿加牙套大概要多少钱？	unrelated
张庭孕肚明显将迎来第三胎，林瑞阳满头白发尽显沧桑	47岁张庭机场近照遭曝光，肚子圆的像球，网友：厉害了林瑞阳	agreed
女生没必要节食减肥，穿这几款呢子大衣修身显瘦，穿上就瘦10斤	女生减肥多用这些实用的小工具，尤其是第二个，会让你轻松变瘦	unrelated
研究古代木乃伊显示癌症是人为的现代疾病	令人不安:研究人员终于证实,癌症纯粹是一种人为疾病	unrelated
神奇！喝水放了它，排出体内10年毒，年轻10岁不是梦！	红豆加一物，暴瘦20斤！排出10年毒！	unrelated
2018年秸秆补贴，每项补助1万元到1000万元！	洗脸水中加“一个宝贝”，肌肤越洗越白，7天之后白过卫生纸	unrelated
三十年后的城市将不适合居住赶紧搬迁到农村吧 经典语录	三十年后的城市将不适合居住，赶紧搬迁到农村吧9	agreed
UFO最真实的视频现场！外星人真的存在吗？	明星都是如何快速减肥的，这样减肥真的健康吗？	unrelated
网传视频徐州一孤儿被亲身大伯栓在门上，遭虐待	指甲没月牙=不健康?为什么大拇指都有月牙?	unrelated
昨晚，武僧一龙遭美国特战队长重拳KO！师傅场边看的瞠目结舌！	武僧一龙挑战美国选手被下黑手后 怒用金钟罩霸气KO对手	unrelated
7月1日交强险和车船税都要改？	7月1日起一大波新规来袭 车船税涨幅过半	unrelated
「健康」吃辣椒还能降低死亡风险？这几类人再馋也要克制！	大蒜和它一起吃，一辈子不得血栓，癌症、胃病躲着你走，健康到老	unrelated
真的有些食物孕妇一吃就流产吗？	辟谣：孕妇见红就要生？全面解说“见红”和“出血”的区别！	unrelated
火箭夺冠稳了！三巨头均愿意选择降薪加盟，卡佩拉还敢叫要1亿？	林心如宣布退出娱乐圈，苏有朋劝阻 一个动作表示对林心如的疼惜	unrelated
坏消息：继ofo被爆料大范围贪腐之后，摩拜也被爆巨额贪腐	惊爆摩拜三大核心高管一年贪掉数亿 投资人傻眼	agreed
"巴中网民在微信群造谣“""一号桥19岁女子被杀，抛尸河里”"	常见的这种东西，用它煮水洗头，头发渐渐变黑，比用染发剂还管用	unrelated
分享妙招排出体内10年毒、漂亮又健康，聆听美妙歌声心旷神怡！	三天排出体内10年毒素	unrelated
“飞机就要起飞，一个男人在机舱口跪下！”	“飞机就要起飞，一个男人在机舱口跪下！”这是今天最催泪的一幕	agreed
维生素E祛斑美白妙用，皮肤白净光滑就靠它了	巧用白梅花美白祛斑 好容颜就是靠它了	unrelated
《印囧》即将上映, 看看这阵容是准备冲击新纪录吗	徐峥发文澄清没拍《印囧》，网友：心累，期待了这么久却是谣言	disagreed
保护眼睛 手机保持40厘米距离	看手机很伤眼 距离最好40厘米	agreed
竹子开花—少见	老师正给同学讲竹子开花的事情，突然听到消息竹山上的竹子全完了	unrelated
张召忠：一但爆发战争，美国来也没有用中国强大实力想干啥就干啥	默克尔：若美朝爆发战争 德国不会自动站美国一边	unrelated
女人生没生过孩子，从这三个部位一眼就能看出来，包装再好也没用	癌症的“天敌”，4种碱性食物每天吃一点，有利于抗癌防癌	unrelated
穿秋裤会丧失抗寒基因?不穿秋裤会得关节炎？	穿秋裤会丧失抗寒基因？！	agreed
惊世奇闻新生儿手握避孕环出生	婴儿手握避孕环出生 这就神奇了	agreed
宋祖德曝周星驰跟足浴店老板娘生了个儿子 评论却把网友看哭	宋祖德爆周星驰儿子已10岁，儿子妈妈是足浴店老板娘？	agreed
兵马俑二号坑重大发现，物品科技领先世界两千年，或与外星人有关	山东农民发现外星人抢他自行车后与之搏斗 电死一名收藏在家	unrelated
咳嗽不用止咳药，只此一招，便能去根！	任何咳嗽，不用止咳药，一招便能去根 很多人都不知道	agreed
失眠多梦气的想跺床，老中医给你1种食物，一觉睡到天亮	失眠多梦、睡不踏实？你其实睡了个假觉！教你几招，一觉到天亮	unrelated
九江市民疑在九九隆超市买到“塑料紫菜”，打汤后嚼不烂难扯断	紫菜大米粉丝都是塑料做的？这“十大谣言”传得特别邪	unrelated
方便面脱掉“垃圾食品”帽子，可以放心吃？	方便面致癌还有毒？那些年误传的谣言，是时候澄清了	unrelated
临沂金盾三小发生儿童诱拐未遂事件？！临沂网警权威回应！	辟谣，网传广饶南塔交通事故信息不实，请广大网友勿传谣信谣！	unrelated
《向往的生活》穿帮 何炅插秧 却换2次衣服 哪有坚持不休？	何炅穿着千元衬衫插秧，黄圣依穿名牌干活，真人秀是用来炫富的吗	unrelated
大蒜还能戒烟？看完这个视频，我立马告诉了身边抽烟的亲朋好友	大蒜还能戒烟？看完这个视频，我立马告诉身边抽烟的亲朋好友	agreed
女人们都知道戴银饰对身体好，但你知道银手镯戴哪只手排毒吗？	「辟谣」谁说冬天不适合戴珠宝？这4款保证你戴上后不想取下来！	unrelated
有说周莹才是杜明礼救命恩人，还有说杜明礼与周莹是失散多年兄妹	《那年花开》杜明礼是周莹的亲哥哥？两人真实关系系兄妹	unrelated
传言币安三天流入5万枚比特币！官微辟谣：还能再假一点吗？	阻断比特币海外交易属谣言，国家为何要严厉处置比特币？	unrelated
刘明炜高考准考证丢失	71岁老教师为给“刘明炜”送还准考证半夜未眠 警方查证是谣言	disagreed
嗑瓜子治病	以后可以光明正大当老公面嗑瓜子了，其实嗑瓜子也能治病	agreed
农村的3个重点位置将被“占领”，这些农民要发财了	2018年，农村3个重点位置被占，这些农民要“发财”了！	agreed
疑问：妹子你是从下水道里爬出来的吗？	地下城与勇士 从下水道爬出来的手被踩到的漫游	unrelated
她曾和释小龙相恋，和赫子铭离婚后还被泼脏水？	释小龙回归，前女友嫌弃，如今事业巅峰，前任离婚	unrelated
6年前她为了学业退出娱乐圈，如今回归颜值比肩杨紫关晓彤！	4岁就出道，比关晓彤迪丽热巴还要火，如今却因为这事退出娱乐圈	unrelated
不用在为电发愁啦！用废旧电子原件自制太阳能板充电宝	教你自制实用干电池应急充电宝	agreed
2018年秸秆补贴，每项补助1万元到1000万元！	洗脸时加这两样东西，你的皮肤像婴儿般细嫩	unrelated
腰间盘突出不花钱，一把艾叶艾草轻松搞定，1次见效，3天断根！	腰间盘突出犯了？猪尾巴+木瓜，不花一分钱，半月就见效！	unrelated
如今《囧》的热播，徐峥开始筹拍《印囧》黄渤王宝强强力联手	徐峥携手《印囧》王宝强黄渤霸气回归！直呼这回绝不会再请这个人	agreed
段子手雷佳音回应“大小合同”，逗翻网友！	雷佳音经纪人辟谣大小合同纯属编造，直言：有戏拍不错了 有毒！	unrelated
女子跳楼未遂 对面看热闹的小伙失足坠楼摔死！	男子看热闹爬上阳台失足摔死？警方辟谣	unrelated
刘涛被爆有19岁私生女，为拿角色甘愿被潜，王珂回应耐人寻味	冯提莫做主播之前的职业被扒出，怪不得连王思聪都不敢“要”她！	unrelated
买西瓜别挑到公的了，老农教你3招辨别公母，买到肉甜皮薄母西瓜	老瓜农说漏嘴才知道，原来西瓜也分公母，看好这几处，百挑百准	agreed
啤酒洗头白发变黑发	简单有效的小窍门！白发掉头发别乱治了，大妈只用啤酒，全解决！	agreed
班级群传出“偷小孩团伙被抓”，又是假消息！	辟谣｜“瓯北有人偷小孩” 提醒市民不要轻信	unrelated
快速美白的牛奶珍珠面膜，自己下手制作吧	不要让闺蜜知道：晒黑后怎么快速变白 5妙招助你美白	unrelated
生活圈丨这7个您认为“正确”预防感冒的方法千万不要乱用！	千万不要乱用牙膏了	unrelated
网传腾讯放弃代理《绝地求生》国服 正在小伙伴失望时腾讯发话了	腾讯辟谣PUBG国服发布会：工作证哪做的？	unrelated
洗头发小技能：先用护发素再用洗发水	洗头要先用护发素再用洗发水，效果超震撼	agreed
范冰冰亲口承认了隐瞒13年的恋情	爆料~范冰冰亲口承认了隐瞒13年的恋情	agreed
睡前按2分钟这个穴位，刮掉多余脂肪，腰围速减3公分	睡前按按这个穴位，健脾利水，虚胖实胖都能瘦	agreed
章子怡被曝怀二胎，已预订豪华月子套餐15万，网友：汪峰真厉害	章子怡被曝疑似怀二胎，已预订豪华月子套餐15万	agreed
监控清晰拍到:8个毛骨悚人的“幽灵”袭人事件	诡异!监控拍下幽灵袭击男孩	unrelated
中国股市惊天消息：机构大佬一语爆出市场顽疾！空头开启另类砸盘	中国股市最大的骗局被澄清，A股深陷谣言风波，散户该何去何从？	unrelated
狗狗生下半人半狗的怪物，原因让人心痛	母狗竟生下一人形怪物，这究竟是怎么回事？	agreed
网传西瓜和桃子同时吃会致命？网友以身试毒，结果……有点撑	辟谣：桃子和西瓜一起吃马上致命？假的！	disagreed
王凯陈乔恩恋情曝光，都见母亲了这是要结婚的节奏啊	安以轩结婚，赵又廷却对陈乔恩说：恭喜恭喜！你和王凯也快了吧？	unrelated
看完想恋爱的视频，迪丽热巴 、鹿晗高颜值cp，甜的不要不要的	鹿晗恋爱被喷审美有问题，迪丽热巴尴尬了，炒作这么久图个啥？	unrelated
AI发展出人类无法理解的语言 脸书关闭“失控”项目	AI发展出人类无法理解的语言 脸书关闭失控AI项目	agreed
海口飞机撒药治白蛾	紧急辟谣 飞机又来撒药治白蛾了？别再传了，是假的！	disagreed
白发有救了，用这种叶子洗头，坚持5天白发彻底变黑发，永不褪色	用洋葱这样子洗头，三天白发快速变黑，在家也能做，快学起来	unrelated
聊城市住建局发声明 “告诫居民不要买房”系谣言	增城从化要限贷？传言不实 调查：四成网友暂放弃买房	unrelated
茄子不能和什么一起吃 油炸茄子会影响身体吗	茄子不能和这种食物一起吃，容易引发胃炎	unrelated
大衣哥朱之文多次“被离婚”，另娶对象就是于文华？	大衣哥朱之文和于文华私密照片暴露，他老婆气得三天三夜不合眼？	unrelated
中医减肥法：3天瘦2斤、排便顺畅，一个月轻松瘦成小蛮腰	中医减肥法：一个月轻松从143瘦到102，其实减肥没有那么难	agreed
南丰划龙舟发生打群架事件？	辟谣：划龙舟打架 造谣者已被拘留	disagreed
定了！徐州到成都高铁要开通啦！票价、车次、时刻表曝光…	关于“中国原子城号”红色旅游列车运营时间、票价的辟谣公告	unrelated
心脑血管病突发吃阿司匹林可救命？听听北京卫计委怎么说	阿司匹林、硝酸甘油、速效救心丸，急救该用哪种？关键时刻能救命	unrelated
2017国庆节深圳限行吗 2017国庆节外地车可以进深圳吗	广州市交委：10月21日全市限行外地牌是假消息	unrelated
王骁曝高圆圆怀孕 赵又廷回应“子虚乌有”	马化腾回应妻女谣言：王丹婷和马曼玲都为子虚乌有	unrelated
「精选」北上广等12城暂停共享单车投放	北京交管局再辟谣：新规只是新增渠道	unrelated
外卖小哥：女士，谢谢你的差评，让我放下了心中最后的坚持	外卖小哥雨中痛哭：人过三十，你没有权利做一个穷人	unrelated
“坏男孩”教你 追女生这五个技巧，让女生疯狂爱上你	快女慢男？通过观察宝宝胎心的快慢强弱来知道生男生女！	unrelated
来电话不想接，教你将手机号码变空号，您拨打的电话是空号	心情不好时不愿接电话，教你将手机号码一秒变空号，赶紧留着备用	agreed
潘玮柏吴昕正式交往？“绯闻体质”的她换了发型立刻搞定男神	潘玮柏吴昕在一起了？34岁吴昕靠穿搭逆袭，160以下跟着学！	unrelated
几粒阿莫西林，学会洗脸新方法，脸蛋又白又嫩！	阿莫西林和白醋混合一起使用，大妈脸上白白，肌肤嫩似90后！	agreed
“马云女儿要结婚”转发信息得300话费？	爱心筹款因转发次数不够无法到账？谣言！别再转发了	unrelated
廉价iPhone X确定：一半的价 不变的性能	廉价版iPhoneX曝光 网友炸锅 后悔买早了	unrelated
微信群疯传“夏某某准考证丢在庐江荣信修理厂”	辟谣！刷遍朋友圈的“给同一天生日的贫苦孩子捐钱”又是假的？！	unrelated
儿子女友竟是46岁的杨钰莹，鲍国安的反应令人很意外！	谢霆锋王菲已经分手？谢母证实谢霆锋和张柏芝复合？宋祖德赢了	unrelated
2017会计证取消了怎么办？会计从业资格证取消了吗？	会计初级职称也要每年年审——谣言？	unrelated
监狱一伙人欺负新来的小伙，谁知道小伙是位一等一的高手	监狱老大带一伙人欺负新来的犯人，没想到对方是一等一的高手	agreed
懒人减肥瘦身诀窍，只要一把葡萄干加点醋，15天轻松告别肥胖！	张柏芝为了孩子会答应谢霆锋的复婚吗？	unrelated
你喝的不是茶而是毒药?	最近传遍网络的茶叶农残问题，竟是虚构，别再为谣言交学费！	unrelated
刘恺威的生日礼物难道是小小糯米？杨幂二胎了？	杨幂逛街买衣服 含胸驼背肚子大 颜值下滑 疑似怀二胎！	unrelated
女星长相像章子怡，因这事被张国立儿子张默殴打！	曾志伟儿子捧出俩金马影后，房祖名张默吸毒为父抹黑	unrelated
如果京东合并唯品会，对于天猫有啥影响？	网传京东唯品会秘密谈判并购事宜，两家公司负责人辟谣	unrelated
又一项惠民政策来啦！农村结婚有补贴，大家赶快看过来！	你们知道吗现在农村结婚也有补贴了，但是要怎么申请你们清楚吗？	agreed
五岁女儿被人贩子拐走了，一年后父亲找到她时，却发现她没了双手	5岁女儿被拐？这样的谣言好多城市都传过！	disagreed
确定了！2018最新的农村房屋拆迁补偿标准和注意事项都在这里	全聚德前门店被拆系传闻 仅店内200平板房是违建	unrelated
关晓彤多次表白李易峰，为何最后没成为情侣？何炅一句话戳中痛点	没想到，国民闺女关晓彤直言要嫁李易峰，李易峰面对表白	agreed
最近不能晒被子晒衣服？听说飞机来福安撒农药治白蛾？	辟谣｜15-25号室外不要晒被子，因为飞机喷药治白蛾？	unrelated
窦靖童剃光头发！第一批90后真的已经出家了？	窦靖童剃光头出家？网友，第一反应周冬雨可怎么办哟	agreed
吃酱油皮肤到底会不会变黑？这里有“打酱油”的正确姿势	吃酱油太多人会变黑？	agreed
博白至水鸣路段出现老虎？真相在这里！	辟谣：富平没有太伏镇，别闹了！纯属谣言！勿信勿转！	unrelated
吃鸡蛋切记不要和这三样食物一起吃，小心食物中毒！还会得肺结石	吃鸡蛋后千万不要吃这些食物 小心中毒！严重会得结石！	agreed
芯片第一龙头沉睡3年，中报净利飙增千倍，5月或赶超科大讯	芯片第一龙头沉睡7年，中报净利飙增千倍，五月或赶超科大讯	agreed
保定警方辟谣河北“蠡县加油站爆炸” 将严处造谣者	网警辟谣︱“临海充气蹦蹦床发生爆炸满天都是孩子”系谣言	unrelated
毛宁入狱后杨钰莹含泪唱出这首歌，唱哭毛宁！	音乐：毛宁入狱，杨钰莹为他唱了这首歌，太感人了	agreed
中国天眼，超美国成全球第一，为何外媒称：会成外星入侵媒介	独生子女家庭有钱领了，补贴金额最低1000元，你符合条件吗？	unrelated
父亲10年前的无心之举，10年后给我带来了30万的收益	赵丽颖、郑爽首次合作，颖宝给郑爽做配角，李易峰成为男主	unrelated
智齿不用拔，中医有妙法	智齿长得比较正，是不是就不用了拔了啊？	unrelated
明年起，农民工工资实行“月薪制”，网友：农民工的福利到了！	明年开始，农民工工资“月薪制”将全面覆盖	agreed
科学流言榜，你中招了吗？——洗澡先洗头会导致脑溢血？	洗澡先洗头会导致脑溢血？	agreed
宋祖德曝：周星驰有个11岁的“私生子”，母亲竟是足浴店老板	周星驰和足浴店老板娘隐婚儿子十岁？揭爱隐婚的明星们	agreed
暴雨中，广西一对母女公交站触电身亡！记住这些关键时候能保命	暴雨夜“漏电致死”事件谣言盛传 事故女子正在救治	unrelated
2017古钱币最新行情走势，2017古钱币最新报价	战狼：17年春季古钱币价格行情揭秘	agreed
48岁钟丽缇被传怀四胎后首现身，小腹微隆嘟嘴卖萌可爱似少女	曝48岁钟丽缇再怀孕 网友偶遇其现身妇产科做检查	agreed
「警情通报」网传平顶山市双楼乡麦田发生火灾系谣言	网传“当阳玻璃厂落雪砸到一个小孩”系谣言！	unrelated
家有宫颈癌病人，如何防止传染？	宫颈癌！可传染的癌症	unrelated
大家快看，结婚也有补贴啦！娶媳妇不用愁！不知道就亏大了……	2018年3月14 花呗套现、	unrelated
糖尿病人不断增加 无糖食品前景看好	张柏芝称要将孩子改姓张，谢霆锋回应太无情！谢贤一句话很霸气！	unrelated
杭州下沙成艾滋病重灾区？谁再说把这条微信甩他脸上！	辟谣：滴血验癌不可能 马赛克疫苗不能阻止艾滋病	unrelated
《楚乔传2》赵丽颖离开，林更新被接替，元淳竟换了这个人！	赵丽颖林更新被拍到《楚乔传2》开机仪式，燕洵世子正在看剧本	unrelated
网曝张若昀唐艺昕分手拒同台，有多少人不相信？	张若昀和唐艺昕这对虐狗的恋人要分手了？	unrelated
对于谢霆锋王菲的甜蜜画面，张柏芝隔空喊话前夫	狄波拉忏悔提张柏芝哽咽，喊话王菲：放过我儿子吧，他太不容易了	unrelated
春天吃什么水果最好？	补血的水果有哪些？女人最该吃，补血养颜不显老	unrelated
老太及孙子六人翻车溺亡？多地证实为谣传！	辟谣：最近很火的女孩掉入岩浆事件真伪	unrelated
牙膏底部有黑色条会致癌吗？	旭日阳刚被封杀“纯属谣言”，王旭：求别再说我和刘刚不和了！	unrelated
2017年农村养老补贴新增种类，详细金额已出，需要的申请吧！	辟谣！乌市老龄办：60岁以上老人免费乘公交传闻不实	unrelated
水果中的“减肥大王”！减肥期间吃这6种水果最有效	适合减肥期间吃的东西水果篇	agreed
36岁的他离开赵本山之后，搭上新的靠山，如今携新剧强势回归！	已经37岁的他，离开赵本山之后，搭上新的后台，如今强势复出！	agreed
优酷击败央视拿下世界杯网络直播权	优酷击败央视拿下世界杯网络直播权？都是谣言	disagreed
民间一“天然胰岛素”，每天喝水泡一点，三个月糖尿病不攻自破	陈乔恩公布恋情，不是明道，不是王凯，而是他，网友：眼光好准！	unrelated
上班就瞌睡？春困来了，中医教你这三招，头脑清醒不犯困	朱之文拉着于文华的手唱歌，台下沸腾，那英跪了，刀郎醉了	unrelated
刘涛拼命工作帮王珂还了4亿巨债 王珂竟又欠下巨款	情感主持人涂磊被离婚！首爆老婆正脸照打破谣言，网友：果然真爱	unrelated
47岁钟丽缇怀第四胎，又来关键证据，拍广告时用想办法遮盖肚子	47岁钟丽缇已怀四胎？小12岁丈夫张伦硕这样回应	agreed
脂肪的“头号克星”来了！每天一杯，水蛇腰回来了，气色也好了	厉害！中国天眼已发现43颗脉冲星，难怪霍金当时会反对	unrelated
张一山相恋七年女友曝光，张一山深藏不露，连杨紫都不知晓	张一山隐瞒多年女友终曝光，不是杨紫，而是和张一山大学同学的她	agreed
白衣服发黄不要扔，这样处理下，衣服跟新的一样	白衣服发黄别再用洗衣液洗衣粉，学会这一招，让发黄衣服洁白如新	agreed
范丞丞恋情被扒出，女友是富二代网红，范冰冰会同意吗？	富二代的飞机首飞就打破了世界记录，还被日本盗用去炸珍珠港	unrelated
中国让世界倒退五百年的三大武器曝光，令美日忌惮不已！	用微波炉加热食物的8大危害，别怪我没提醒你！	unrelated
明星没架子，张艺兴过度劳累，医院看病被偶遇	张艺兴看病被偶遇，惹网友心疼，一定要注意身体啊！	agreed
新闻说过纸麻将清朝以前就有，昨天看新闻还说重庆小伙发明？	重庆小伙发明纸牌麻将 有人出50万购买专利被拒绝	unrelated
传言币安三天流入5万枚比特币！官微辟谣：还能再假一点吗？	「辟谣」深圳市真出现了投入使用的比特币提款机？	unrelated
明年起，农民工工资实行“月薪制”，网友：农民工的福利到了！	明年农民工工资实行“月薪制”，黑心包工头将成为历史	agreed
喝酒千杯不醉的小妙招，你们学会了吗？	酒精唯一克星，酒前偷偷吃三口，喝不倒灌不醉，酒后不头痛不恶心	unrelated
张一山被曝因宋妍霏才接真人秀 张一山宋妍霏是怎么认识的	张一山恋情坐实了？看那热搜大起大落就知道不简单！	unrelated
住院超15天无法医保报销	胡歌和刘亦菲终于结婚了，可是胡歌为什么半路逃跑	unrelated
脸上长了斑点不要急，教你2个祛斑的小妙招，让肌肤更显细腻白皙	脸上暗黄无光，维生素E倒入蜂蜜洗一洗脸，皮肤亮白显年轻	unrelated
有人证实了 摩拜单车轮胎确实是实心的	V早报：警车的轮胎被偷了？警方辟谣更换轮胎	unrelated
周冬雨给她的礼物竟是这个，要作为阚清子和李易峰结婚的贺礼	《英雄志》将拍？原著作者辟谣：对方违约合同失效	unrelated
勒索病毒出变种！你的支付宝、微信等手机支付软件安全吗？	贵州恒丰开出罚单，原因是相关负责人没有对千万奖金进行及时辟谣	unrelated
何赛飞初恋男友曝光：这么帅气，却成为她唯一的男人	郑爽17岁初恋男友完虐胡彦斌，帅气堪比杨洋！	unrelated
老人信偏方，竟种百株罂粟泡酒治病	紫砂壶开水煮有气泡才是真？别信检测偏方，谣言！	unrelated
艾灸这条经，能治疗你身上一多半的慢性病	急性乙肝和慢性乙肝有哪些区别？哪个更容易治疗	unrelated
公公强吻儿媳后两家人现场斗殴？现场视频系张冠李戴	网传“无锡五爱路裸女不雅视频” 网警辟谣	unrelated
经常失眠睡不着，夜尿频多？睡前微微吃一点，每晚一觉睡到大天亮	老是失眠睡不着，夜尿频繁？睡前偷偷喝一杯，让你一觉酣睡到天亮	agreed
《楚乔传2》即将热播，宇文玥复活保护楚乔，女二竟换成演技派的	三项只对独生子女发放的补贴，还不知道的父母赶紧去申领吧！	unrelated
5个证明外星人存在的视频原版	西红柿快速瘦身法，这样减肥不反弹，你还不试试吗	unrelated
4月1日起驾考有重大变化？只是科一科四学习更规范	辟谣！“驾校科目一和四必须网络打卡80小时”？不存在的！	unrelated
文章骂儿子	文章被外国人骂了还听不懂，竟然让儿子给他当翻译	unrelated
传言币安三天流入5万枚比特币！官微辟谣：还能再假一点吗？	“中国比特币首富”李笑来被传非法集资被抓，朋友圈辟谣：谣言	unrelated
千张supreme公交卡免费领？假的！	辟谣！网传南阳发行“限量版异形公交卡”？	unrelated
洪金宝和范冰冰到底有什么深层关系，洪金宝凶狠气势吓到女记者！	只要谈及洪金宝评论就出现范冰冰，范冰冰和洪金宝到底什么关系？	unrelated
家里大厅切记不能有这种现象，聪明人都会避开！	这种杯子不能用来喝水，每个家里都有，看见之后赶紧换掉！	unrelated
实录：UFO最真实视频大集合 -国语流畅，外星人真的存在	2017最新快速减肥食谱，让你2周瘦18斤	unrelated
吃香蕉减肥好！不过香蕉的热量要先知道！	吃香蕉会不会长胖 香蕉减肥的正确方法是什么	unrelated
孩子一生1次的大脑发育高峰期，错过之后就真的难以弥补	孩子一生一次的大脑发育高峰期，错过之后就难以弥补！	agreed
周立波判刑41年，前妻早有预料？多篇文章细数周立波十大罪证！	周立波被判41年，微博上宣称自己正能量，这次是否金蝉脱壳？	agreed
神马，周立波被判41年，后半生监狱里过吧	詹宁斯澄清扰民报道：这周我就在家两天	unrelated
敷了眼的蛋黄有很多小颗粒,这代表湿气重吗?	蛋黄上的颗粒代表人体内的湿气	unrelated
大衣哥朱之文女人缘极满！这次不仅有于文华还有另外一位美女 7	大衣哥朱之文女人缘极满！这次不仅有于文华还有另外一位美女 4	agreed
网传“持枪斗殴”视频发生在万宁市北大镇？	网传“红灯不许掉头”！真相是这样的	unrelated
研究发现:O型血的人最容易招蚊子	O型血招蚊子？胖子才招呢！	unrelated
朱之文 于文华婚礼现场姐弟恋甜蜜合唱，台下来宾感动的稀里哗啦	朱之文于文华婚礼现场，携手再唱这首歌，乡亲们沸腾，前妻痛哭！	agreed
“独生子女想完全取得父母的房产”，不一定！	新快报：“独生子女无法继承房产”是一堂普法课	agreed
一岁宝宝肾衰竭而亡，奶奶的无心举动却成了一个“杀手”	奶奶给宝宝吃方便面调料导致患上肾衰竭，无知又可怕	unrelated
4亿年前外星人制造的机械装置在俄国被发现	俄罗斯发现4亿年前的机械装置!-UFO与外星人	agreed
2018年新农村住宅建有这3个原则，4地方建房将会收地或罚款	蒋欣假怀孕被发现，气的老公摔门离去，就连老爸都骂她不帮忙了	unrelated
了解孕期胎儿大脑的发育规律，常吃这些让宝宝智力过人	备孕期间吃药打针会对胎儿产生什么影响？这些后果一定要早知道	unrelated
李玉刚太牛了，模仿邓丽君让人真假难辨，差点以为天后再世了！	李玉刚模仿邓丽君火了，一开口甩那英十四条街，完全分不清真与假	agreed
手机电不耐用，不用换电池，轻松提升容量!	电池容量惊人！360手机正式发布旗舰手机N7	unrelated
榆林河因退婚男方杀女方全家七口人	男方因彩礼杀害女方一家7口？谣言让爱情说散就散	disagreed
李宇春被出柜？大学同寝女生爆出照片，称友情爱情走到了尽头	李宇春被出柜？大学室友曝与李宇春情史！	agreed
农村老汉带来价值百万的东西，台上傻乎乎一问三不知	农村这几样东西价值不低于60万，一定得保管好「值得转发」	unrelated
WHO都承认了，“多喝热水”是致癌因素	“多喝热水”有可能致癌？！以后谁让我喝热水我跟谁急	agreed
安阁命理风水：生辰八字测婚姻有多准？看一下便知	一泓师傅：八字推断婚姻早晚，看你何时步入婚姻？	unrelated
手机屏幕有刮痕怎么办·不用怕·我教你	手机屏幕被刮花，不用买新的，教你一招马上就能修复	agreed
在中国山区上空拍摄到一个，像极了传说中的龙一样的不明飞行生物	在青海湖支流拍摄到的，某疑似龙的不明生物	agreed
占道经营当街殴打城管队员 南阳一菜贩被行政拘留6天	孝感城管暴力执法殴打菜贩 系谣言	unrelated
当了多年穷保安，女友不离不弃，如今挥金如土坐拥万贯家财	从120斤到100斤，阿姨每晚睡前用艾叶泡脚，减肥祛湿功效好	unrelated
宋晓峰做传销，差点把传销公司吃破产	史上第一人！宋晓峰你就放过传销组织吧；组团头目都给跪下了	agreed
爱车被贴罚单怎么办？交警提醒：这3种随便撕，不扣分也不罚款	今天教你一招解决鼻炎三天就有明显的效果	unrelated
天空出现两个月亮，地球即将要遭受撞击毁灭	地球若是即将毁灭，太阳系中哪个行星可以改造为人类下一个家园？	unrelated
「新规解读」物业新规！这8种情况，我们可以拒缴物业费！	新《物业管理条例》今年实施，这5种情况可以拒交物业费！	agreed
一周E车评｜长江获纯电动乘用车生产资质，百度投资威马汽车！	电动汽车初创公司威马汽车将获数十亿元投资 百度领投	unrelated
女神范冰冰的弟弟，范丞丞深夜与女友秀恩爱，女方背景太惊人！	家世背景显赫惊人，前男友个个不凡，黄志忠还为她抛弃糟糠之妻	unrelated
柳林高家沟昨晚又发生一起离奇案，搭顺车者和车主都失踪	忻州县医院一孩子被撞身亡？搭顺车者和车主失踪？系谣言！	unrelated
临沂金盾三小发生儿童诱拐未遂事件？！临沂网警权威回应！	eStarPro官方道歉：没有及时澄清“偷梗”事件	unrelated
《歌手》导演洪涛离职，芒果台为何大量人才出走？	洪涛亲破离职谣言！搭档梁翘柏和天后开辟新音乐节目	disagreed
快乐大本营：赵丽颖、陈伟霆真的太配合了，好喜欢赵丽颖小姐姐	陈伟霆握夫人赵丽颖的手，好幸福	unrelated
大蒜不能和什么一起吃	医生告诫：大蒜不能和这4种食物一起吃，否则就是给自己找病	agreed
昌吉东方广场走丢了小女孩	谢娜狂删张杰微博信息又爆新料，这次真的是离婚前的预兆吗？	unrelated
温婉被抖音封杀，转入新平台强势复出，网友：很强势！	一直都希望能有个女宝宝，没想到生下来真是个小千金！附孕期症状	unrelated
一位天才操盘手的讲述：为何突破平台的股票极易暴涨？	股票一旦出现以下强势股买入信号，立马满仓干，牢牢抓住暴涨牛股	unrelated
荷叶这样用，坚持每晚一杯，刮油排毒，水桶腰迅速消失	荷叶煮水喝，每天一次扫光体内脂肪，减肥不困难	agreed
50元纸币，如果出现这种号码，一张价值29800元！	霍建华妈妈一不小心说漏嘴，为何霍建华娶林心如，而不娶陈乔恩！	unrelated
目睹水鬼拉人，之后村民合力抽干水库，最后看到这么恐怖一幕	村民目睹水鬼拉人后，合力抽干水库 最后看到恐怖一幕！	agreed
刘强东回应京东入主延边	卓尔辟谣“欠水费”事件！声明：俱乐部运转一切正常	unrelated
2017年农村土地被征收补偿：一亩地补贴多少钱？	迪丽热巴追男友新技能太厉害了，出手更是大方！	unrelated
当年的黑社会老大女儿成了妈妈，陈小春也成了警队督察	陈小春为不当这黑社会老大，招兵买马重出江湖准备大干一场！	unrelated
《美人鱼2》吴亦凡艾伦双男主？周星驰方否认	周星驰《美人鱼2》阵容曝光，邓超回归吴亦凡艾伦双男主	unrelated
它被誉为“高血压克星”，早晚来一杯，告别高血压气色棒	“降压药”克星总于被发现，每天一杯，高血压远离你！	agreed
抖音封杀小猪佩奇，从此再无社会人	全网都在找的抖音小哥哥出来辟谣了：不玩抖音，不要打扰我学习	unrelated
Fisker：充电1分钟续航800公里的固态电池靠谱不	固态电池汽车终于亮相，充电1分钟，续航800公里	unrelated
5月1日起，芯片磁条复合卡的磁条交易功能将关闭	5月1日起，复合卡磁条交易功能关闭！但磁条卡还可继续使用	agreed
打屁股有助于智商提升 瑞士心理学最新研究	心理学实验称打屁股可提高智商	agreed
武林风 死神方便复出！首场战对决泰国拳王西提猜五拳KO掉！	李晓旭火线复出战新疆？知情人向暴风辟谣：不可能	unrelated
张艳2岁女儿在大润发附近被人拐走	曹艳2岁女儿在大润发附近被拐？这个谣言竟跑遍全国了	disagreed
情况通报辟谣	OKEx再次回应回滚事件：恶意爆仓毫无根据，操纵交易系谣言	unrelated
范冰冰李晨看豪宅，普通人买不起的豪宅到底长啥样？	李晨范冰冰亿万豪宅曝光，内景欧式设计奢侈至极	agreed
女生来月经期间，如果有这个条件，可以放心洗头发	月经期间可以洗头吗，经期不能吃的食物	unrelated
淘米水加它洗头，三天白头发自然变黑还柔顺，这辈子不用去染发！	枸杞加它这样用，满头白发变黑只要三天，再也不用染发剂！	unrelated
奇书《推背图》第54象：黄河清，圣人出！有人知道什么意思吗？	胡歌进传销，演讲功力太深，连同事都分分钟变迷妹！偶像潜质！	unrelated
李小璐和贾乃亮正要离婚，没想到再次怀孕了！	李小璐这次铁了心的要跟老公离婚	unrelated
茶叶加白糖用开水泡来喝，解决了所有男人的烦恼，看完都要试试	茶叶加白糖一起喝，没想到解决了很多人的烦恼，看完一定要试试	agreed
iPhone 9真机概念图曝光！刘海屏+无下巴，颜值惊艳！	iPhone 9真机来了：后置变成单摄拍照更清晰？	agreed
盘点七大神秘怪物 咕噜姆海怪雪人五花八门	日本海滩上突现“魔戒的咕噜” 这个怪物真的存在么？	unrelated
手机垃圾总是清理不干净，原来是这里的设置没有改，快去试试	只清理手机垃圾是没有用的，这样设置一下，再也不用担心内存不够	agreed
扒黍爆料：郑爽得了抑郁症？尚雯婕整容上瘾？胡彦斌经常玩？	郑爽街头落泪，就被“抑郁症”？看到这样的爽妹子，心疼！	agreed
网传平罗六中学生打死人？假的！	苏锡常谣言大比拼：近日最大的谣言暴雨中的一幕“神龙”	unrelated
真相：木瓜丰胸？别傻了！	生活小常识：木瓜丰胸是谣言，真正功效在这里！	unrelated
汽车油耗总是高？这些零件该换了，油费可以省一半！	警车轮胎被盗？警方发布消息辟谣：实为更换轮胎	unrelated
扣掉车牌小圆点可免于被抓拍	《楚乔传2》开拍：宇文玥复活，赵丽颖怀孕，剧情虐心造型惊艳	unrelated
穷人的机会来了，2018抓住这五大行业，傻子都能赚钱！_2	穷人的机会来了，2018抓住这五大行业，傻子都能赚钱！_6	agreed
别再花钱染发了，教您一个小偏方，3天白发变黑发，还不复发	您还花钱染发吗？老中医祖传秘方，爷爷才用了3天白发就全变黑了	agreed
中国发动机为何落后美俄20年？只因缺少这一关键材料	中国获得这款武器堪称非常厉害，性能不成熟一切都是谣言了	unrelated
小猪佩奇遭抖音封杀，抖音从此再无社会人！	高考迟到因忙拍抖音？官方回应：造谣消息	unrelated
网联再对支付宝下重手，涉及信用卡支付 马云：让我静静	银监会回应收紧信托融资通道传闻：系例行检查	unrelated
特种部队执行任务，结果丧尸病毒爆发，队员开始一个个变异	辟谣特工队｜看出汗部位得出哪里得病？厉害了！	unrelated
扒一扒我的怀孕症状，大家都以为怀的女儿，结果生了儿子，意外啊	胎心低生儿子，还真是这样，分享儿子孕期症状，进来的都生儿子	agreed
李连杰生病严重，表示想回国安葬！又一位功夫巨星要离开我们了3	又一位功夫巨星要离开我们了，李连杰病情严重，表示想回国安葬！	agreed
中医老专家教你每天刮一刮，成就无斑的你，美白看的见	中医专家巧献妙方，解决面子问题，美白养颜又祛斑效果看得见	unrelated
手机只清理垃圾没有用，赶快设置这个功能，手机立马焕然一新	手机变卡了只清理垃圾没有用，赶紧这样设置一下，手机流畅如新机	agreed
房间里放上它，蚊子全部都死光，无毒无害	房间放上它，蚊子死光光，还不伤身体！	agreed
牙齿发黄还花钱洗牙干嘛？10克小苏打加上它，7天牙齿白3个度	小苏打使牙齿变白	agreed
抖音蒙牛慢燃减肥代餐奶昔多少钱 你们喝它瘦了多少	判刑！蒙牛“黄曲霉菌”谣言炮制者获刑10个月	unrelated
国外记者山边采景时拍摄到大山开门	国外记者山边采景的时候拍摄到大山开了门，并瞬间关闭	agreed
女子与猪同床4年，牛B！	北京一女子养170斤猪当宠物 与猪同床4年！	agreed
我从98公斤减肥，每天跳一会不节食，现在86公斤	美女减肥30天暴瘦30斤，反而怒告减肥茶“疗效”不显著	unrelated
大黑牛李晨情史风流，堪比国民老公王思聪，范冰冰为何会看上他？	李晨求婚范冰冰成功！最后一次深扒大黑牛情史	unrelated
农村将有大动作！解决4大农村问题，6类村干部将被罢免	男子有一张5角纸币，还说能价值10万！网友：我也有！	unrelated
2017新农合新增五项补贴，有这些慢性病的农民速去申请！	45岁以上农民注意，新农合新增5项补贴，你都拿了吗？	agreed
民间趣话：华夏五千年，最神秘的生物，深海和云雾中是否真的有龙	无意间闯进地底世界！科幻小说成了现实！小伙从此走上人生巅峰！	unrelated
孕妇坐地铁时可以要求别人让座吗？	地铁小伙欺负孕妇，围观群众竟然纷纷拿起手机拍照	unrelated
「网警辟谣」蒙山坝头发生村民拦截偷狗贼事件？谣言！	西安女子散布谣言 在微博上发“枪击视频”被拘留5日	unrelated
眉毛还能决定寿命长短？身体出现这个信号，可能是大病征兆！	央视主持康辉跟谢娜同台主持，称无法交流	unrelated
林宥嘉结婚，邓紫棋终究只是路过了！	林宥嘉结婚了，留给前女友邓紫棋的却是一个谎言	agreed
徳裔获全球一半诺奖的秘密:宪法禁止学前教育	为何德国人拿走一半诺贝尔奖:禁止学前教育	agreed
盘点那些让成龙愧疚的女人们 车晓也在内	被成龙祸害的女人们，最惨的只有18岁，吴绮莉连前三都算不上	unrelated
家人珍藏治病偏方 简单、实用	上世纪20年代老中医分享的一些治病偏方	agreed
教你一个最有效的小窍门，豆腐面膜，几天就变白，再晒都不怕黑	阿司匹林配白醋，教你一个变白最有效的小窍门，脸上水嫩嫩	unrelated
医生建议多吃这种食物，它是抗癌冠军，赶紧收藏吧！	你觉得杨颖整容了吗？	unrelated
复合了？容祖儿刘浩龙约会庆生难掩笑意恋情回暖	容祖儿真人秀合体王菲，疑和前男友复合庆生，男友变帅了	unrelated
吃大盘鸡、泡椒凤爪能感染禽流感？	网传“泡椒凤爪携带H7N9流感病毒”系谣言	unrelated
下周或迎来变盘，大盘转折即将开启，这些个股明天开始起飞	明日大盘预测，周五大盘跳水收跌，会出现黑周一？明日怎么走？	unrelated
上班族如何快速减掉肚子上的赘肉，常吃这几种水果，瘦身且排毒！	减肥并不难，中医教你一招，帮你消掉大肚子	unrelated
央视都播了！60岁以下逮捕罚款，今天起全国严查棋牌室？	辟谣：朋友圈疯传!全国严查棋牌室 60岁以下人员一律逮捕	disagreed
最新秸秆补贴：每亩可补1万-1000万元！（附申请补贴办法）	教你一招，洗面奶和它混合在一起洗脸，皮肤越洗越白	unrelated
很多人都不知道！独生子女不能单独继承父母房产，亲戚要来分房	4月1日起独生子女将无法继承父母房产？辟谣：非唯一继承人	disagreed
怎么样才能生儿子？生男孩的秘诀！	宪哥开车咯，告诉你怎么生男孩的秘诀，现场笑岔气	agreed
吃海鲜喝啤酒，容易得痛风吗？	痛风喝不得啤酒，喝菜油	unrelated
好消息！4.5吨以下普通货车营运证、从业资格证将取消	从多个角度看4.5吨以下货车取消营运证和从业资格证	agreed
今年养老金调整进落地期 高龄退休人员养老金涨得多	辟谣！所谓“上海企业退休人员游行抗议”视频实为拼接编造	unrelated
口臭，口腔溃疡烦不甚烦，我来一招轻松搞定	一招解决口臭口腔溃疡	agreed
继ofo后，摩拜三大高管集体被曝贪腐：一年分赃数亿人民币	摩拜高管贪腐事件是造谣！胡玮炜发飙起诉知乎	unrelated
他在河边捡了块石头，价值五十万！我也捡了一块，能值多少钱？	男子路边捡到一块其貌不扬的石头，没想到价值上千万，太惊喜了！	unrelated
皮肤晒黑晒伤快速恢复美白小方法	蜂蜜配“它”，自制一种美白面膜，两周快速美白，越来越水嫩	unrelated
可乐中含有高量致癌物	可口可乐百事可乐在美国被检出高含量致癌物	unrelated
菠菜营养高，补铁补贴，这么做才有效！	多吃含铁丰富的蔬菜水果就能补铁	unrelated
千万不能放在冰箱的6种食物！但有很多人第一个就中了	餐桌上的这几种食物，吃不完也不要放冰箱，再吃会危害身体健康	agreed
清河广场出车祸、伤者找不到家人	交警提醒：驾驶证“替人销分”新规出台，驾驶证代扣分已成过去！	unrelated
北京道路拥堵不堪 地铁涨价怎么上班？	凤凰街采：北京地铁涨价后有何感受	unrelated
微信更新超重磅功能，让你不花钱就可以上网，一定要打开！	打开微信这个功能，随时随地连接WiFi，出行上网特别方便	agreed
一姐朱迅被癌症折磨不成人样，因癌症复发退出舞台	王志称朱迅是生命中最重要的人，三次癌症复发曾是央视最美女主播	unrelated
最新消息：小米以630-680亿美元估值招股询价！	小米最高估值680亿美元？两周内路演？雷军回应：谣言	disagreed
水果早上吃才好	早晨吃水果 营养最好	agreed
今年起这4种违章终于不扣分了！新交规网友拍手称好！	这4种违章行为只罚款不扣分！	agreed
吃羊肉感染SK6病毒？广东疾控：根本无此病毒！	宁波三人吃杨梅感染SK5病毒身亡？传谣的，你的智商被吃了吗！	unrelated
《花千骨2》赵丽颖由刘诗诗来接替，消息一出，网上马上炸了锅	《花千骨2》男主霍建华女主赵丽颖或换刘诗诗	agreed
孕妇必吃的12种食物 孕期饮食注意	孕期不能吃凉的？这些饮食谣言专坑中国孕妇	unrelated
6分钟头发乌黑告别染发，不管白发多疯狂，用橘皮这样洗就OK了	董卿退出央视，台下含泪一首歌送给央视领导，朱军失控痛哭！	unrelated
农村残疾人两大专项补贴来了，最低领80元，最高领2000元了	低保新增两项补贴，最低领80元，最高领2000元！	unrelated
把手机放进大米里太厉害了，放一次可以省下不少钱，简直太实用了	手机放到大米里，放一次能为家里省下不少钱，看完视频我信了	agreed
世界最高薪！曝山东鲁能年薪2.44亿请温格执教	请温格执教？山东鲁能辟谣	unrelated
终于不用再花钱染发了，用生姜和“它”洗头，一周白发变黑发！	啤酒水加个它洗头，3天白发全部自然变黑，这一辈子都不用去染发	unrelated
宝妈们关于宝宝睡觉的6大危害你做了几个	【谣言粉碎机】新生宝宝睡觉要绑着睡？你还要被老传统骗多久	unrelated
减肥瘦身方法睡前做一做，每天少2斤腰细5cm	减肥瘦身纤体，这样吃才可能体脂率降低下来，而不仅仅是瘦了几斤	unrelated
向华强干出这事，逼成龙下跪，暴打人家曾志伟，见这2人却怂了！	向华强逼成龙下跪 打的曾志伟像猪头 却不敢动这2个人	agreed
宜昌市松线虫高发，因药物防治而致松菌带毒	捆扎蔬菜的胶带甲醛超10倍？吃了这种蔬菜会中毒吗	unrelated
在爱尔兰禁止离婚	爱尔兰一个禁止离婚的国家	agreed
手脚僵硬，坐立困难，艾叶秘制巧妙用法，多年的腰间盘突出也管用	董卿怀孕，宣布暂退娱乐圈，含泪一首歌，台下老公哭的泪如雨下	unrelated
四十多天大雨后真龙现身，白色方头眼睛很大 腾云驾雾！	茶麸原浆洗头，排出硅油，吸收营养，白发转黑、防脱生发。	unrelated
宇宙中96%的区域是暗物质，科学家是如何发现暗物质的存在的？	美国卫星悄悄探测到：中国沙漠存在大量神秘黑点，科学家坐不住了	unrelated
余文乐成功晋级当老爸，妻子王棠云曾是李宗瑞事件女主角！	余文乐妻子王棠云产子，恭喜余文乐升级变身当爸！	agreed
小苏打这样抹头发，白发再顽固，8分钟头发乌黑如墨，告别染发	小苏打这么抹头发，不管白头发多凶，三分钟乌润如墨水，告别染发	agreed
4月1日起，驾照考试更严格啦！还没过的抓紧！	网传徐州驾考增考科目五为谣言！误信！	unrelated
洗不掉色！阿司匹林+这样洗白发，5分钟白发黑如墨染，值得珍藏	一洗就掉色，草莓用了染色剂？盘点朋友圈近期 5 大谣言	unrelated
“地震云”到底能预测地震吗？	四川九寨沟地震，地震云并不存在！这些谣言不要信	unrelated
微粒贷花钱就能开通和提升额度	让微粒贷开通并提升额度就靠这六字诀，马化腾手里的钱不难借！	agreed
木星：八大行星中的发光者将取代太阳	木星30亿年后将取代太阳，是福还是祸	agreed
无籽葡萄用避孕药种出来的，会致不育？	网传无籽葡萄靠打避孕药？是真是假看专家怎么说？	agreed
吃大盘鸡、泡椒凤爪能感染禽流感？	网传“雷州徐闻有人吃大盘鸡感染禽流感死亡” 警方辟谣：假的！	unrelated
小沈阳被赵本山怒斥一顿 接赵本山电话打哆嗦 2	赵本山给小沈阳打电话，小沈阳吓得打哆嗦 5	unrelated
农村大姐种桃树不摘桃子，却摘桃浆，年收入近百万	农村大姐种桃树不摘桃子，却摘桃树浆，一年收入近百万	agreed
儿童低辐射电话手表推荐，这功能苹果都没有	儿童电话手表有致癌物？消委会辟谣	unrelated
三明一楼房倒塌现场辗压死了好几个人	白头发谁还花钱去染发啊，这样洗头白发很快变黑，试过的人都说好	unrelated
5个证明外星人存在的视频原版	夏天真的来了，看了这些买家秀，更忧伤了！如何减肥快速有效？	unrelated
当主持人问赵丽颖，男朋友如果劈腿怎么办，赵丽颖霸气回答	马云说2018年最赚钱的三大暴富行业，绝对很多人能把握	unrelated
吴亦凡学宋小宝雨露均沾 李晨不吃蝎子就娶不到范冰冰！	成龙与范冰冰这么亲密，还不认识李晨？网友：难怪迟迟不嫁	unrelated
爆李易峰吸毒，影响挣钱可就不好了	李易峰吸毒？发微博怒破谣言	unrelated
医学史上历史性重大突破！如今一滴血也可测癌症了	这支中国医疗团队发明出一款癌症“照妖镜”，一滴血可测癌症	agreed
宝宝喝酸奶等于补充益生菌？其实没有那么简单	喝酸奶真的能补充益生菌吗？	unrelated
女朋友视角下的易烊千玺实在撩人，不多，我也只看了99遍而已！	李小璐小腹微隆街头疑似怀二胎？素颜现身旁人小心搀扶！	unrelated
2018你农村一亩地补贴多少钱？答案…	2018必领的10项农村补贴，你领了吗？	unrelated
汽车尾气比空气干净10倍,机动车对雾霾的贡献并没有那么大	高血压最怕的1杯茶，1碗粥，1锅汤，经常吃两口，血压稳降不升	unrelated
注意了！发生以下情形，业主可以拒交物业费	辟谣：看病需交药事服务费？襄阳市未收取此费用	unrelated
使用红米手机wifi信号差？这个开关一定要打开	高铁上手机信号不好怎么办？	unrelated
疾病科普——幽门螺杆菌感染	明年起，农村这三种宅基地将进行收费，农民朋友一定要注意了！	unrelated
网传“白花一KTV夫妻争执发生命案”？谣言！	科学家也传谣？未经证实便“发现”新引力波	unrelated
《旅行青蛙》里的青蛙会死！养蛙的玩家们注意点吧！	旅行青蛙的“三大谣言”：青蛙会死，青蛙不回家！	disagreed
姚明2.0版，周琦正式加盟火箭！他或成为火箭的第三巨头	美记报道周琦前队友阿不都沙拉木参加NBA选秀，本人已辟谣	unrelated
“唐僧”迟重瑞不爱女妖，却被富婆降服！开的是奔驰还是宝马？	唐僧家的翡翠大曝光，价值过亿	unrelated
农村以下这六种补贴最高可领5万元，很多人都不知道！	退伍军人的好消息！尤其是农村户口的，最高补贴高达5万元！	unrelated
死亡率最高的5款车都有哪些？	死亡率最高的5款汽车，看看你的车中招了吗？	agreed
脸上总长痘痘和痘印难去除！教你一招，美白祛痘还抑制粉刺生长	刚刚，又一个地雷引爆了！乐视巨亏难逃退市？	unrelated
原来大肚腩最怕这个食物，家家厨房都有，不节食就瘦掉肚腩	香菜这样喝，一周减去脂肪，两周瘦了15斤，轻松甩掉大肚腩	unrelated
秦皇岛惊现白衣男子身背砍刀入室盗窃	身背两黄继续踢？容大为对手辟谣：字幕出错	unrelated
「麦子说」为什么不能空腹喝牛奶？	空腹真不能喝牛奶吗？	unrelated
光绪元宝，大清银币，咸丰重宝，袁大头，等钱币的价值排行榜	光绪元宝价格如何？市场价值飙升！2018年光绪元宝价格	unrelated
农村长的这种菜，经常吃降低血压、血糖，预防心脑血管疾病！	营养师最爱的食物，家有高血糖的人常吃，胆固醇平稳降下！	unrelated
巴中现“100元感谢费骗孩子上车带路”？是谣言	「辟谣」：朋友圈里百元感谢费诱使小学生上车带路是谣言	unrelated
李亚男现医院探望新生儿，一双大长腿抢眼，想沾沾喜气怀上宝宝！	二胎顺产男宝，分享生产过程与孕期症状，希望能给大家带来好孕气	unrelated
女子公交站摔倒，脖子卡进护栏身亡，相似事故已连发多起	张店女子公交东站脖卡护栏身亡？警方回复系谣言	disagreed
住宾馆一定要小心针孔摄像头，教你一招用手机就可以把它找出来	宾馆里到处是针孔摄像头，只需拿出手机就能找出来，一找一个准	agreed
耍帅我只服刘德华，在黑帮老大面前依旧凌威不乱，气场压倒一切	刘德华半夜潜入黑帮老大房间偷什么……	unrelated
美墨战争中墨西哥几乎亡国，美国为何没有趁机吞并	这国销毁所有核武器，成为美国手中“棋子”恐走向“亡国之路”!	unrelated
成龙车祸死亡现场图片	日本研发纳米胶囊专门攻击癌细胞	unrelated
92号汽油将被取代，新型汽油全面上市，油价又要涨了	教你如何看懂B超单，判断出宝宝的性别，有B超单就来看看吧！	unrelated
最新UFO飞碟目击录像—NASA泄漏视频证明了外星人存在	减肥开始的季节，郑多燕10分钟快速甩脂4	unrelated
网传“多人感染SK5病毒死亡”系旧谣新传	昆明网警辟谣：《战狼2》链接系窃取手机资料病毒”系谣言！	unrelated
女子跳楼未遂，看热闹的人却失足坠楼遇难？警方回应了！	女子跳楼未遂，结果看热闹的男子不慎失足坠楼身亡	agreed
芯片第一龙头沉睡5年，中报净利飙增千倍，5月望赶超科大讯飞	芯片第一龙头沉睡4年，中报净利飙增千倍，5月或赶超科大讯飞	agreed
手机辐射能量惊人 65分钟煮熟鸡蛋?	啊!手机辐射能爆米花!	unrelated
德驻华大使扬言，德系车将全线退出中国市场，赚中国人钱还这么牛	驻华大使辟谣：冰岛队无业余球员 中国队闻言松了一口气……	unrelated
穿羽绒服得禽流感，能不能再扯点？	「辟谣」禽流感，最近鸡鸭都不能吃？专家这样说	unrelated
王菲被爆怀孕，事隔6年谢霆锋喊话张柏芝：“我很后悔了”！	谢霆锋高调接机张柏芝，机场大吵后王菲挺着孕肚黯然离场	unrelated
一个适合新手的创业赚钱项目，做的好还可躺赚做到月入过万！	十大适合年轻宝妈的小本创业项目推荐，边带娃边赚钱	unrelated
微信聊天记录不慎丢失？输入一串代码就能恢复，太神奇了	想想都恐怖电脑、手机上的聊天记录删除后竟然还能被恢复？	unrelated
判断男宝女宝性别的小秘密，妇产科专家来告诉你	美国科学家新发现：“巨人木乃伊”，远古巨人族真的存在吗？	unrelated
广州地铁烈士陵园地铁站进水	杨幂千万豪宅长这样，赵丽颖的画风非一般！	unrelated
不到7万的自动挡车型 东风风光S370上市	不到8万起，轴距近2米8 配置豪华的商务级家用车	unrelated
你们知道哪种食物和哪种食物相克吗？	养生饮食禁忌：鸭肉和这些食物相克，爱吃鸭肉的要知道！	unrelated
刘德华可能“永远”退出娱乐圈？	她痴情不愿退出娱乐圈，只因害怕失去与刘德华见面的机会！	unrelated
微信不仅可以直接看电视，利用这个功能还可以看电影，都是免费的	小白技能厂—微信上能免费观看最新电影了！还有很多人不知道！	agreed
日本“记忆力口香糖”成海淘代购新宠 但真管用？	8块钱一包的记忆力口香糖，真的有用？	agreed
生姜加它洗头，无论白发多凶，3分钟转黑，一辈子不染发！	白头发越来越浓密不要怕，生姜加它这样洗头，不出3天全都变黑了	agreed
今天是世界无烟日，教你一些快速戒烟的小妙招，非常实用	戒烟妙招：只花2元钱，就能轻松戒烟，多久烟龄都适用！	agreed
孕妈喜获6斤6重“小王子”分享孕期怀男宝的症状快来接“好孕”	顺产7斤8两儿子 我的怀男症状居然是这样	agreed
娱乐圈二婚三婚挺正常，却没想到林心如也是二婚	林心如居然是二婚，华哥，你知道么？	agreed
林丹母亲说出真相：谢杏芳为何第二天就决定原谅林丹	不怕挨骂！谢杏芳揭原谅林丹出轨原因 不准爱子学林丹打羽毛球	unrelated
你坐火车时见过火车司机吗 你知道他们工资多少吗 说出来吓死你	火车司机一个月工资有多少？说出来吓死你！	agreed
网传飞机撒药治白蛾 乌鲁木齐园林部门回应：假消息	辟谣：榆林“市园林办”飞机撒药治白蛾通知为虚假消息	unrelated
新恋情？张翰和张钧甯假戏真做？这一举动就能看出	原来你是这样的张翰！再爆新恋情：揭秘塘主恋爱打开方式！	unrelated
双语：中秋节的起源、传说及习俗（附央视中秋晚会节目单）	新年晚会能从周五看到周日，四大卫视主打嘉宾、节目单提前曝光	unrelated
花儿乐队的大张伟吸毒吗？	大张伟被传吸粉，被谣言中伤的人还少吗？	unrelated
吃杯面胃里留蜡	吃货大胃王20个杯面轻松吃光，这么多都够吃一个月啦！	unrelated
空腹究竟什么不能吃？看完才知道自己吃错了这么多东西！	趣谈：空腹真的不可以喝牛奶？	unrelated
太开心了，今天借呗开通8万！这是双十一马云给我们的惊喜吗？	毛孔粗大皮肤变糙？其实是螨虫在作怪，教你一招，皮肤变白变嫩	unrelated
句容限购松绑消息不实 江宁再出楼市新政	江北最新购房门槛出炉！官方辟谣：8号线今年开工纯属谣言...	unrelated
新密某游乐场打死人？造谣者昨日删除视频，现已被警方拘留	孩子抢玩具家长互殴致一方成植物人？多地进行辟谣	unrelated
娜扎首次回应与张翰分手？	辟谣申明:孙尚香并未重做，有作者偷换概念	unrelated
你还在为减肥烦恼吗？吃这几种水果可以可以帮助你哦	你还在为减肥烦恼吗？多吃这几种水果可以帮助你哦	agreed
再久的咳嗽，治一个好一个，什么药都不吃！	黄海波和高圆圆被误传离婚，老戏骨张凯丽大闹她家！	unrelated
多位资深孕妇总结，生男生女的8种不同症状，真的挺精准！	生男生女早知道，五大孕期症状帮您准确判断胎儿性别	agreed
中央美院给予葛宇路记过处分，因为私设路牌	出轨男女有别，贾乃亮做不到原谅，李小璐痛哭不已！	unrelated
白发变黑有奇招，淘米水发酵拿来洗头，七天见效，一辈子不用染发	用这个水洗头，白发很快自然变黑发，这辈子都不用再染发了	unrelated
在大葱上嫁接葡萄成功了，而且当年还吃到了甜葡萄	大葱，嫁接葡萄成功了	agreed
再见了，烧烤！易县多部门联合执法，坚决取缔……	辟谣！易县网警11小时击破网络谣言“易县偷孩子”	unrelated
手机中尽然有监控的功能，以前一直不知道，做过什么太清楚了	手机被别人监控时会有这样的特征，赶快看下你的手机有没有被操控	unrelated
普洱茶=致癌茶？ 广东省疾控中心抽查结果竟是......	普洱茶是否致癌这个话题你怎么看？	agreed
肚子鼓鼓像怀孕？每天睡觉前白开水吃二片，整晚刮油燃脂，快存	肚子鼓鼓像怀孕？每天睡觉前白开水吃一片，整晚刮油燃脂看后收藏	agreed
50岁王菲大肚痛哭，含泪告别谢霆锋，李亚鹏一语惊醒梦中人 1	50岁王菲挺大肚痛哭，含泪告别谢霆锋，李亚鹏一语惊醒梦中人	agreed
喜大普奔！小米持续冲刺手机销量，台湾厂商却赚得满盆金	独家｜一季度 小米手机销量竟然跌这么多	unrelated
崔永元揭露：某演员出演4天片酬6千万	4天六千万！崔永元疑开炮范冰冰天价片酬	unrelated
腰腿疼痛，屁股酸麻，艾草巧妙做法，多年腰间盘突出都管用	腰酸腿麻，腰间盘？农村土方艾草配上它，多年腰间盘突出也管用！	agreed
张柏芝与小十岁鲜肉男星大婚，你信吗？	刘涛被传离婚 这内情疑似曝光，制止类似谣言的继续散播	unrelated
手机辐射能崩爆米花吗	手机辐射可以爆出爆米花?防辐射贴有没有作用?	agreed
昆凌说周董有时白有时黑，生第三胎要等到30岁？	再上热搜！昆凌生完两胎注重保养考虑生第三胎？周杰伦笑而不语	unrelated
云南建水城管对小贩拳打脚踢？实为张冠李戴	网曝“上海企业退休人员游行抗议”视频 警方辟谣	unrelated
吃大盘鸡、啃泡椒凤爪、穿羽绒服……容易感染禽流感？	网传广东深圳有人吃鸡肉感染H7N9 警方：这是谣言！	unrelated
快速美白小方法	快速补水、美白、遮瑕，一抹即白，却根本看不出化了妆	unrelated
WiFi开一整夜会影响健康吗?	郑爽热搜体质被怀疑，难道真是买的吗？	unrelated
汪星人GIF圖: 哈士奇為報恩女主，竟把男主的私房錢全找出！	哈士奇为报恩女主，竟把男主的私房钱全找出！这样的狗给我来一沓	agreed
网传湖南近期有大地震？市地震局：谣言！	地震局号召捐款？关于九寨沟地震，这些都是谣言！	unrelated
“男神”吴彦祖将在哈工大再续建筑梦！	重燃建筑魂 吴彦祖将到哈工大深造？	unrelated
伊利董事长潘刚失联被带走调查？潘刚最新消息	网上造谣“伊利董事长被调查”者被呼市警方在京抓获	unrelated
到2040年通过人类大脑皮层与机器的结合，人类将实现永生	人类可在2030年实现永生？谷歌总监爆出惊人预言！	agreed
抖音封杀小猪佩奇，《后来的我们》太失望，从此再无社会人？！	注意！滴滴出行遭到谣言说将迎来无人驾驶，滴滴司机竟很开心！	unrelated
牙膏放到白酒太实用了，不知道就亏大了，赶紧试一试	牙膏和白酒混在一起，效果太有效了，很多人都不知道，太实用了	agreed
百度创始人李彦宏春节后透露，2018这个行业最赚钱，	百度回应“李彦宏小三”传闻：纯属子虚乌有 已报案	unrelated
宋丹丹公开怒斥儿媳：这四个原因，使得宋丹丹对儿媳妇极为不满！	宋丹丹儿子要结婚 网友：儿媳妇不好看，真是比宋丹丹看到还老	unrelated
女子情绪狂躁摇头晃脑被质疑得了狂犬病 结果竟是……	辟谣 ！一男童疑似狂犬病发作，学狗狂叫不止？！真相在这里！	unrelated
荆门市公安局发布街上发的钥匙扣可定位追踪，市名不要随意领取	钥匙扣追踪器？多地警方辟谣：老谣言	unrelated
山东天才 13岁开公司 14岁获麻省理工录取	网上疯转麻省理工教授盛赞中国神话 本人辟谣：我没说过	unrelated
王珂二度破产欠下六千万巨款 刘涛再次痛哭 网友：这钱有蹊跷	马奎兹辟谣：别说六千万，就算一亿也没用，我肯定不会再打帕奎奥	unrelated
天津静海传销人员丧心病狂当街杀人	一网民发布“人贩子”谣言被行政拘留	unrelated
一次冒出五架！普京悔不当初，俄罗斯：后悔出口苏35到中国！	俄罗斯为何忍痛出口苏35？需要中国帮忙改进一关键性能	unrelated
网爆任娇跳楼轻生，疑与华谊力捧小生杨旭文有关	女演员任娇被曝跳楼自杀 这事还和一位杨旭文有关？	agreed
李小璐出轨再被添石锤又怎样？贾乃亮早在节目中就原谅了她	李小璐沙发事件遭热议，工作室晒原图辟谣，网友：此地无银三百两	unrelated
三明一楼房倒塌现场辗压死了好几个人	淘米水这样洗头，不管白发有凶，3分钟白发变黑，自然柔顺	unrelated
专家教你减肥妙招，这2物一起熬水喝，刮油排毒，体内脂肪全扫空	减肥太难？睡前一杯，刮油又排毒，体重唰唰往下掉	unrelated
喝碱性水有益健康吗？	鲨鱼不会患癌症只是伪科学，你是否被误导了好多年？	unrelated
夏天蚊子多，教你一“土方法”，来一只蚊子灭一只	张嘉译情妇	unrelated
工地上挖出百米巨蟒，竟口吐人言，工友不听劝阻终遭报应	建筑工地挖出一条巨蟒，工人吓得不敢动，最后只有叫来了挖掘机	agreed
10年高血压，一古方，治一好一个，1月后血压稳降，请存！	高血压就只是少吃盐？降血压需做这5点，哪怕只做到1点也好！	unrelated
千万别信！广州现假违停“罚单”：扫二维码可交罚款？	说长道短 违停罚单上印二维码 千万不要扫	agreed
艾滋病治愈	相互告知：电动车新规实施，这些电动车禁止上路！否则扣车罚款	unrelated
茄子和蘑菇能一起吃吗 茄子不能和什么一起吃	辟谣：蘑菇和茄子不能同吃？不仅不会中毒，还有大大的好处！	unrelated
水里放点姜和盐，洗头7天白发迅速变黑发，一辈子都不用在去染发	食盐这样洗头，20天白发消失，恢复满头黑发，再也不用去染发了	agreed
王欣的妻子在等他出狱 而黄光裕的太太已经为他备好江山	黄光裕年底出狱：马云 刘强东将如何应对 又是一场厮杀(54	unrelated
世界首例“长生不老药”问世？人或可活到120岁	肝病肝癌9大症状！常常发现已是晚期，赶快学会自己检查！	unrelated
白头发越来越多？这些食物能让你的头发慢慢变黑，回家记得多吃点	姚明女儿被李湘女儿叫“农村娃”，孩子应该活在父母的光环下吗	unrelated
安阳公共自行车车桩雨后漏电	交警设卡查车导致车祸、自行车车桩漏电···这些谣言你信了吗？	unrelated
2017高考‘0分作文’山东卷，最有良心的作文！	高考作文阅卷“5秒定终身”？谣言！阅卷老师告诉你真相！	unrelated
不快乐？吃香蕉！想减肥？吃香蕉！提高智商，晚上还睡得好！	香蕉减肥新方法，这样吃轻松减脂瘦身，夏天秀出好身材	agreed
保定巨力大桥一货车发生起火爆燃	老人抚养孙子14年考上复旦，发现“重病去世”的儿子还活着	unrelated
戒烟方，90%的人不知道，3天可以戒掉你手中的香烟	戒烟很难吗？农村小伙教你一个快速戒烟的小妙招，3天戒掉	agreed
白百何深夜拍戏收工心情大好，中医馆调理身体疑准备生二胎！	白百合已怀上二胎？现身陈羽凡一路相护 那孩子是……	agreed
13岁少年与挺肚子新娘结婚 网友：单身狗伤不起	13岁就结婚生子，三十出头的奶奶亲自给孙儿喂奶！	agreed
晚饭后这样锻炼等于慢性自杀？	晚上锻炼等于慢性自杀？官方已经辟谣：胡扯！	disagreed
又一场撕逼大战，唐嫣公然“手撕”杨幂，真得防火防盗防闺蜜啊！	秒杀杨幂唐嫣塑料姐妹情，“假脸姐妹团”才是真撕逼啊！	agreed
癌症是人为导致的现代疾病	令人不安:研究人员终于证实,癌症纯粹是一种人为疾病	agreed
中国自主研制的量子隐身衣	王健林豪言：未来唯一超过马云暴富行业 看懂下一个富翁就是你！	unrelated
母乳导致新生儿黄疸	新生儿宝宝黄疸｜分病理性、生理性、母乳性（附治疗攻略）	unrelated
拉萨城投成中国最魔鬼主场！客队一场比赛倒下6个	拉萨队主场海拔3658米，客队6人抬出场	unrelated
科学家实验体外基因疗法，发现抗癌细胞，未来癌症有望治愈	癌症没有特效药，防癌抗癌坚持这7条，做得好一辈子不得癌症！	unrelated
徐峥表示《印囧》绝对不再请一人，黄渤宝强齐回归你会去支持吗？	徐峥发文澄清没拍《印囧》，网友：心累，期待了这么久却是谣言	disagreed
手机电池耗电很快？马上修改下这个小设置，电量能多用很长时间！	手机发热后耗电很快？这样设置就可以让手机边降温边省电，很好用	agreed
大蒜和白酒这样吃，比19岁还凶，三天老婆更爱你，比牛鞭还补	大蒜这样泡，比壮年还厉害，吃三天老婆更爱你，比生蚝还补，收藏	agreed
今年农村将要挨家收一项费用，每家近千元，但这5种农民免交！	农村医疗保险年年增长，从明年起，这几类人可免交新农合费用了	unrelated
电影版《花千骨》即将开拍，女主角不是赵丽颖，而是鹿晗的女友	辟谣！醉玲珑不是花千骨！	unrelated
《演员的诞生》或停播 刘烨半夜怒批：二逼节目	袁姗姗发声明怒批和刘烨绯闻是谣言，网友：自导自演的炒作	unrelated
朱之文被全村人唾骂！被迫搬家，走时对村民唱了这首绝唱，感动！	朱之文被同村人唾骂，搬家时为村民最后唱了这首歌，全村人哭了	agreed
男足U23中国球迷“万人血书”,空场抗议不公裁判震摄亚足联！	干的漂亮！u23亚洲杯继续空场，用实际行动抗议裁判不公正判罚	agreed
17天治疗高血压！高血压最怕它，喝水加它清血脂，治愈高血压	劳伦斯拍卖精品推荐：户部光绪元宝当二十文铜币	unrelated
一个月轻松瘦20公斤！这个减肥方法真不是一般厉害！	辟谣文选早上空腹喝一杯淡盐水，能补水	unrelated
网传“倒挂控水法”可以应用在儿童溺水急救中吗？	辟谣，这种朋友圈的溺水急救方法是错的	unrelated
安徽一富婆招司机驾驶七百万豪车，月薪五万，因这3点无人敢应聘	安徽富婆招司机驾驶七百万豪车，月薪五万，却因这3点无人敢应聘	agreed
「警情通报」网传平顶山市双楼乡麦田发生火灾系谣言	网警辟谣：网传“张家界某景区索道桥厢发生火灾事故”系谣言	unrelated
经常失眠睡不着，夜尿频多？睡前微微吃一点，每晚一觉睡到大天亮	如果经常失眠睡不着？睡前偷偷吃一点，相信每个夜晚都能睡到天亮	unrelated
减肥这么吃：瘦8斤！排毒养颜，肚子马上瘦	夏日清爽下饭菜，口感脆嫩，颜色碧绿，秘决在这里	unrelated
30万退出宅基地，2018年农村土地政策出新规！	多地开始回收宅基地，你觉得怎么样？	unrelated
一两八角，治好十年前列腺，6小时见效，前列腺5天去根不复发	前列腺别着急，一把八角5天去根，一用一个行，百试百灵，快看！	agreed
医科院整形外科医院｜外耳术后吃酱油，伤口会变黑吗？	术后不能吃“发物”？别再被这个传言吓到了！	unrelated
周润发因病医治无效在香港去世 网友：别拦着我让我撕烂他的嘴	华夏幸福辟谣:小马哥要走？我怎么不知道	unrelated
双十一天猫旗舰店红包详尽攻略，笔电如何省省省？	天猫双十一红包在哪领 快递借壳物流概念股有哪些	agreed
范冰冰疑似公开婚期，宣布退圈身价大跌网友之前的6000万	范冰冰公开婚期，宣布娱乐圈再见，身价从6000万跌到10万	agreed
杜海涛微博秀恩爱发狗粮，明示想要当爸爸~	杜海涛自曝想当爸爸	unrelated
最新UFO飞碟目击录像—NASA泄漏视频证明了外星人存在	运动减肥超过30分钟才有效？想要快速减肥牢记燃脂的最佳时间	unrelated
人来人往要注意！千万不要让这4种人抱宝宝，对小孩百害无一利	玩手机对人是百害而无一利，你是否也深受其害呢？	unrelated
特大消息：林依晨爆瘦被疑厌食症？	太瘦了！林依晨被疑厌食症 虽消瘦但无一丝“病态”之感面色苍白	agreed
李小璐小腹隆起，这是怀上二胎了？	夜宿门事件后，李小璐事业毁于一旦，疑似在家安心生二胎	agreed
中国到底做了什么？日本企业全体撤资中国，群众一脸懵呆！	女人吃什么食物最能排毒养颜	unrelated
《我们来了3》官宣阵容，节目组要搞事情，网友：准备吃瓜！	5月1日起，全国公交正式成为中国失联儿童安全守护点	unrelated
罗晋唐嫣婚期将近，难道这是奉子成婚的节奏	唐嫣疑似奉子成婚，罗晋大方承认婚期，网友：好好把握罗晋	agreed
微信就可以免费观看全网VIP视频了开心	现场演示：利用手机微信观看电视频道，完全免费！	unrelated
女人这4个部位越大男人越喜欢，第4个让所有男人都沦陷！	男人最喜欢女人哪个部位，越能看出他的本质	unrelated
农村大爷说，地里的这种野菜，男人吃了变生猛，女人吃了可生乳！	农村一种常见的植物，男性吃了变生猛，女性产后吃可生乳	agreed
2017年重庆十大本科学校排名	江苏一本大学有哪些	unrelated
温州惊现注水西瓜？执法人员实验亲测 结果发现	温州实验辟谣注水西瓜 上榜全国辟谣榜单第二位	unrelated
民间大神发明特殊覆土机，专家称：将尽快推行到各个贫困地区去	永动机党徒们请注意:发明大神任文林宣布永动机研制成功了!	unrelated
吴京《战狼3》准备开拍，吴京为了请他放弃了彭于晏！	吴京《战狼3》准备开拍，吴京为了请他放弃了彭于晏	agreed
林心如婚后被婆婆扇耳光，霍建华去哪了	林心如婚后被婆婆打，老公去哪了？看着都心疼！	agreed
别小看这张贰圆纸币，都说它是币王车工的接班人，价格涨了十几倍	这种纸币很难见，收藏市场中是明星，价格涨了六万倍！	unrelated
洋葱不能和什么食物同吃呢？这3种饮食搭配禁忌，后悔知道晚了	洋葱虽然营养，但不能和这三种食物同吃，会给身体带来伤害哦！	agreed
李维嘉暴瘦原因被曝光，老婆龙丹妮真有婚外情吗	揭秘李维嘉老婆龙丹妮后台背景，难怪维嘉能稳居快乐大本营！	unrelated
甲醛可致儿童白血病！	妇幼保健院：儿童牛奶饮品含肉毒杆菌可致白血病？	unrelated
2018年开始，农民禁止在田里做这5件事，违者就受到国家重罚	朱之文被全村人唾骂，搬家时为村民最后唱了这首歌，听完全村落泪	unrelated
东北小伙拿仙人球乘坐电梯 结果遇见美女懵逼了	女子尝试真人版“跳一跳”, 中间放一盆仙人球, 结果尴尬了	unrelated
腰间盘突出的朋友有福了，艾叶配白酒这样做，腰酸腿疼也不怕	腰酸背痛腿抽筋，就用艾草加一鸡蛋，颈椎病还是腰间盘突出都管用	agreed
快乐家族“解体”《快乐大本营》或停播或换将张大大？	谢娜将离开《快本》？官方澄清谣言	unrelated
王者荣耀年底停止运营？天美听了想打人！	“退车潮”纯属谣言！众卡车经销商说年后没人退车	unrelated
河南长葛市两人散布银行将倒闭谣言被行拘	辟谣：贵州绥阳飞机失事已介入调查，散布虚假信息者自重！	unrelated
张靓颖出轨，获半个娱乐圈力挺，网友：冯珂活该	张靓颖牵手同行的神秘男身份曝光 还当过冯珂伴郎	unrelated
中国最牛驾照！火车以外所有车都能开，有几个老司机能拿的出来？	被称为“全能证”的驾照，生平难得一见，除了火车啥车都能开！	agreed
膝盖疼怎么办？一把韭菜治好了10年老寒腿，家有腿疼得快存！	膝盖疼有救了，一把韭菜有奇效，用一个好一个，亲自试过快收藏！	agreed
自从换了新电表电费翻一番？谁动了我的电费？！	乐山八千群众拒交电费？别信，这个谣言都传10年了！	unrelated
孩子发烧怎么办？3个动作帮你速退烧，中医妈妈亲自教你！	孩子深夜发烧39°C，妈妈做3个动作，立退烧！啥药不吃	agreed
凤凰传奇的女搭档竟然换了，和曾毅台上一首歌，玲花台下痛哭流涕	天呐！凤凰传奇女搭档换人了，曾毅甜蜜合唱一首歌，玲花哭成泪人	agreed
23日吉林松原地震，32小时前曾现“地震云”！	网传“地震云”靠谱吗？地球是否进入地震活跃期？请勿信谣言	unrelated
2017年农民每年需按时缴纳养老保险，不然60岁可领不到钱	养老保险满15年就不用缴了？五月的这些谣言太坑人！不要信！	unrelated
沙湾有人吃羊肉得了SK6病毒？切！我还SK2呢！	柚子、西瓜感染病毒？还bp5？这谣言在朋友圈又要转疯了！	unrelated
范冰冰隐瞒19年的私生子曝光？与洪金宝有理不断的关系？！	曾言不需要嫁豪门自己就是豪门的范冰冰与洪金宝的关系，你真知道	unrelated
2岁女童在勐腊县医院附近被人拐走	瓶装水致癌！近9成国际品牌瓶装水样本验出塑胶微粒，真要当心	unrelated
精美钥匙扣系追踪器，千万不要带回家？别闹了！	大冶街上免费发的钥匙扣暗藏追踪器？谣言信息！不要信！	unrelated
你在月经期间洗头或洗澡吗？你知道有这种危害吗？	辟谣 | 洗澡先洗头会导致脑溢血？吓唬谁呢！	unrelated
网友可以在福彩中心授权任何一家网站或机构上进行彩票购买	6035万元大奖无人领？福彩中心辟谣：早已被领走	unrelated
女人一个地方越大反而越长寿，越早知道越赚！	这4个地方“越大”的女人，会更长寿，女人们快来看看中了多少条	agreed
手机总是收到骚扰电话？教你把手机号设置成空号，后悔现在才知道	手机号码还隐藏一个黑科技？只需按下这几个键，1秒就能变成空号	agreed
感染sk5病毒死亡来袭，云南省红河州第一医院躺枪	最陕西｜注意啦！西安市第四医院有人感染sk5病毒死亡系谣言	unrelated
河南驻马店为什么要改名天中市？	被山鸡盯上的黑社会老大估计会很痛苦，走到哪跟到哪	unrelated
全国严查棋牌室，一律逮捕罚款？我差点就信了……	网传成都地铁4号线二期18日开通 官方辟谣:假的！	unrelated
菜市场没人要的它，祛斑堪比美容针，使用5次斑点如下雨般落下	家里放着不用的它，祛斑堪比美容针，用3次让斑点如下雨般落下	agreed
户部造光绪元宝如何快速交易出手变现？	玉石类田黄石最新拍卖成交价格，如何快速交易出手！	unrelated
王宝强一首歌，竟让马蓉哭求复合	马蓉点赞王宝强微博，如果马蓉和王宝强复合会怎样	unrelated
《我的前半生2》将拍	张一山患病多年，年底即将暂别娱乐圈，实在是太累了	unrelated
【网警辟谣】不图名不图利的谣言制造者，被拘10天，有何感想？	辟谣│连云港小学生被偷？实为自编自导自演的大戏	unrelated
分享｜2018年1月出台了哪些地方新能源汽车政策？	谣言｜国家补贴政策阻碍了电动汽车发展？	unrelated
最牛的“全能驾照”，除了火车什么车都能开，生平难得一见！	中国最牛驾照，除了火车外，基本所有车型都能开，很多人不知道！	agreed
景甜微访谈耿直回应背景说：我爸不是景部长	法国生态部长回应性骚扰传闻：谣言“很伤人”	unrelated
朱之文母亲去世，葬礼上放这首歌，于文华哭到断肠，痛心疾首！	于文华母亲去世，葬礼上响起这首歌，朱之文跪地痛哭，忏悔不已	agreed
日本又一名企业全面撤资中国，全因中国一举措，网友：好走不送！	能帮助女人美容养颜的几种食物，快来看看吧	unrelated
李易峰秘密筹划惊喜，浪漫向李沁求婚，把李沁感动哭了	李易峰准备向李沁求婚，可等到关门了也没见李沁的人影，好伤心	unrelated
明星们的家暴，小S遭家暴后，高圆圆深夜发文痛哭	冷面大叔涂磊十足女儿奴，为女儿做饭满满都是爱	unrelated
立秋之后是儿童长高黄金期，经常吃这9种食物，孩子个头猛蹿一蹿	立秋是儿童长高的黄金期，经常吃这7种食物，孩子个头猛蹿一截！	agreed
穷学生两年赚100万，连马云都找他借钱，怎么做到的？	孙正义200亿美元投资贾跃亭的谣言也有人信？	unrelated
网传“多人感染SK5病毒死亡”系旧谣新传	「网警辟谣」朋友圈刷屏的“5月29日停水通知”是假消息	unrelated
最适合夏季吃的4种水果，清热解毒，通便去火！获李时珍大赞	43岁林心如再爆喜事，网友：这个年纪还真敢	unrelated
白菜根煮水退烧防感冒，用大蒜治感冒，能止咳化痰去感冒	正确吃大蒜方法，吃对了能止咳化痰，赶紧学下！	unrelated
45岁宁静现身机场，穿牛仔外套帅气十足，这肚子是怀孕了？	爆炸性新闻来了，宁静怀孕了，那么孩子的爸爸是谁	agreed
男婴手握避孕环出生，避孕失败的胎儿能不能要？	看手握避孕环出生的小宝宝，感叹生命的神奇	agreed
原厂夜视行车仪带来的穿越事件	人类检测到第四次引力波事件：穿越宇宙的时空涟漪	unrelated
伊利股份董事长潘刚被带走协助调查	伊利董事长潘刚疑似被带走？？？是真是假？	agreed
粉丝暴力后，李易峰拒绝上快乐大本营	肚子赘肉一抓三层肉？去厨房拿片生姜，用一个瘦一个，瘦到你想哭	unrelated
啤酒洗头黑发？不可靠！芝麻加它，一内一外，最快2天白发变黑！	她曾和赵丽颖化友为敌 现又撞脸王鸥被网友劝退出娱乐圈	unrelated
经常上火的人，夏季常吃这四“苦”，清热去火，不用运动就能瘦身	减肥还是偏方好，饭后吃几粒，排毒瘦身	unrelated
你以为吴京表情是演出来的？他可是喝了17扎啤酒3两白酒啊	夏日 啤酒 真会喝出啤酒肚吗 160629	unrelated
体内湿气重，别只知道吃薏米，这3种食物祛湿效果也很不错	湿气重的人，这3种水果要少吃！	unrelated
健康小知识 洗澡时间太长可致癌	辟谣！网传洗澡时间太长致癌？是时候告诉你真相了	disagreed
浙江老宅挖出宋代瓷器, 底部刻有五个字, 令专家当场大怒	老宅挖出宋代瓷器，底部刻有五个字，专家看后差点气晕	unrelated
泰国范冰冰双胞胎儿子曝光，和华裔老公大家族共度农历新年！	范冰冰弟弟的近照曝光！是不是她儿子还用验DNA吗？	unrelated
商家应告知年底会员积分清零	年底将至，各种信用卡积分、福利、资格将清零	unrelated
对与甄子丹的恩怨，吴京回应称：感谢他当初的看不起	李连杰甄子丹吴京师兄弟3人齐聚 破不合谣言	unrelated
洗发水跟它混合洗头，再也不用去染发了，头上一根白发都找不到！	白发再严重，洗头放点它，8分钟头发乌润如墨不染发	unrelated
糖尿病有救了！二斤黄豆一块姜，让你血糖平稳下降，3个月了断	迪丽热巴上海大学素颜写真曝光，鹿晗让关晓彤尴尬了！	unrelated
刘丹避谈儿子刘恺威绯闻 要让小糯米学打高尔夫	小贝再次出轨家庭教师？贝嫂：谣言！网友：儿子学老爹学的真好	unrelated
摄影师冒险打探范冰冰李晨网传婚房 千万别墅金碧辉煌带空中花园	辟谣大会：青岛下水道与菲律宾离中国的距离	unrelated
想要宝宝出生远离黄疸，孕晚期多吃这几种食物，再不喜欢也要吃	要吃鹅蛋喝黄连水去胎毒？这些谣言专坑中国妈妈！	unrelated
外媒曝《除暴战警3》又将跳票 计划延期至2019年发售	《除暴战警3》跳票至2019年2月 更多消息将在E3公布	agreed
盘点一下生男生女秘方，你会觉得哪种方法最靠谱？	教你掌握生男生女的秘方 学会这些技巧要啥有啥！	unrelated
2017劳动法新规：用人单位辞退员工补偿标准！	员工被企业辞退是怎样的补偿标？2017劳动法新规颁布！	agreed
美军战机再次空袭叙利亚，一座校园被轰塌，俄战机升空迎战	“白色头盔”在叙救援被指系造假：救的其实是已死亡儿童	unrelated
“史上最冷春节”卷土重来！	史上最冷春节要来？谣言！	disagreed
中国“赚钱”最多的寺庙,僧人用袋子装钱，香油钱铺满地都是	中国最赚钱的寺庙，和尚每天用麻袋装钱，百万豪车随便开	agreed
一大优势助巴萨逆转皇马获得西甲联赛冠军！	巴萨皇马盯紧国米后防新星 经纪人回击谣言“留下来拿意甲冠军”	unrelated
凌晨4点，特朗普被紧急叫醒：此国正式向美国宣战	这国仅有200正规军，却敢在二战期间向全世界宣战！	unrelated
用微信就能观看最新的高清免费电影，不用下载，在线观看哦	打开微信这个功能，免费看VIP电影，不知道真是亏大了！	agreed
拉黑了还能这么聊天！关于微信拉黑、删除好友那些事	朋友圈发郭德纲被拉黑？谣言！	unrelated
31岁赵丽颖做手术，男友全程陪伴，网友：终于现身了	睡觉前耳朵这样贴一贴，体内脂油全部扫光，轻松瘦身	unrelated
日本百万居民组团到中国认祖归宗，真实目的让人哭笑不得	日本百万居民来中国认祖归宗，真实目的让人哭笑不得	agreed
2018考研数学扎了百万学子的心，神押题or泄题	出事了！2018考研数学疑似泄题！	unrelated
火车司机一个月工资有多少？说出来吓死你！	火车司机一个月能赚多少工资？看完真是想不到	agreed
任静付笛生近照，双双皈依佛门，儿子帅气酷似老爸，音乐天赋极高	《知心爱人》原唱付笛声、任静皈依佛门	unrelated
芯片公司2000万净利润就可以快速上市了	“芯片公司2000万净利润就上市”是谣言	disagreed
美白只需三步，教你正确快速美白	马云告诉你2018年穷人出路在哪里，不要错过 1	unrelated
农村这几样东西，价值如黄金，城里人很羡慕，别再说做农民不好了	在农村，这东西狗都不吃，但是对人来说，却是很有价值的草药！	unrelated
国六标准就要来了，旧的车都不能上路了	真假难辨！马蓉首次回应王宝强财产分割：错不在我	unrelated
曹德旺 房地产崩盘是迟早的事	“玻璃大王”曹德旺：房地产迟早崩盘 有房要尽早卖	agreed
史上排量最低的宝马豪车，1.5T发动机却卖198万销量惨淡	红旗要打翻身战，和奥迪A4L同品质，这款新车才卖15万	unrelated
美前官员称要在台湾部署核武 国台办回应	美军要在韩部署战术核武？青瓦台辟谣：没有的事	unrelated
晚饭这样吃，比不吃瘦的都快，还更加健康，然而很多人都不知道！	晚饭不吃，有益于健康吗？	unrelated
原来这里有长生不老药	这些症状 是肝癌早期	unrelated
QQ在欧洲下线	官方回应！QQ大面积故障正在解决！手机QQ被迫关闭？纯属谣言	unrelated
崔永元炮轰范冰冰“真烂” 机密天价片酬外泄	崔永元炮轰范冰冰千万片酬 范冰冰方发声明回应崔永元炮轰是谣言	disagreed
张靓颖冯轲离婚案的真与假，尚雯婕发文证实	张靓颖冯轲离婚被证实谣言 怎么就不能盼着人家好呢？	unrelated
曹三玲：乳腺癌患者能不能吃豆制品？	辟谣丨吃豆制品导致乳腺癌？喝柠檬水能美白？女神们该醒醒了	unrelated
每天喝一杯它 一月后血压降了血糖稳定，高血压只能依赖降压药？	高血压怎么办？坚持每天一种茶 每天泡一杯效果看得见	unrelated
硬币收藏中的“空模对撞”，一枚价值十万！	网传价值十万的硬币，有的赶紧收藏了	unrelated
杨紫和霍建华拍戏曾交往怀孕？	洛瑞怒怼谣言：我没说无意留队	unrelated
农民工注意：明年农村低保待遇将提高，但5种人不能继续吃了！	我市农村低保标准再提高	unrelated
《演员的诞生》持续升温，袁立连发26条微博手撕被上热搜头条	为了尊严，袁立开撕《演员的诞生》，针对目标并不是章子怡	unrelated
你是否了解二战时德国三个不同的军队：冲锋队、国防军、党卫军？	打破纳粹国防军军纪严明的谣言，这一支部队罪行铁证如山	unrelated
东太行景区玻璃栈道上首创玻璃“碎”效果 游客吓趴	东太行景区玻璃栈道 “碎裂” 导游吓得现场大叫	agreed
自导自演？白百何陈羽凡已复婚！剧组合体大秀恩爱	谢娜辟谣复出回归晒搞笑视频:没去机场没逛公园没直播	unrelated
康震为你讲解“焚书坑儒”的真相，秦始皇想追求长生不老药！	秦始皇被坑惨了，焚书坑儒是谣言，残暴无道是被人蓄意抹黑	unrelated
王源-易烊千玺撕逼，整容事件到底是谁先撩者贱呢？	TFboys王源否认整容传闻，一证据让谣言不攻自破	unrelated
花5万能低价购公租房	日本直升机驱逐舰半小时击沉中国航母！有可能吗？	unrelated
天眼射电望远镜到底有多牛，霍金生前为何反对？看完你就明白了	中国贵州的“天眼”，到底有多厉害？难怪霍金生前极力反对	agreed
保释后首现身！高云翔顶光头穿紧身T状态很好	高云翔案，二次保释两好友带700万前来，董璇现身破二胎谣言？	unrelated
大衣哥朱之文嫌弃糟糠之妻要分手，另娶对象就是于文华？	大衣哥朱之文讲述最近与老婆关系，于文华听了非常开心全场惊讶！	unrelated
中国高铁第一跨，64个轮胎悬空，看如何将900吨桥梁成功对接	厉害啦！郑州上演万吨桥体空中“大挪移”，成功对接郑万高铁	unrelated
世界最高薪！曝山东鲁能年薪2.44亿请温格执教	鲁能辟谣温格执教传言李霄鹏获力挺 为教授无缘鲁能说一声可惜	unrelated
土豆皮熬水染发，白发立即变黑？这样治疗白发才有效又安全	白开水加它洗头，再久的白发，10分钟黑如墨水，一辈子不染发了	unrelated
专治疑难杂症老中医，一招赚了一百万	老中医教你一招专治慢性腰痛的法子 每天坚持按摩效果显著	unrelated
湿疹宝宝皮肤敏感，不能使用润肤剂	湿疹宝宝因为皮肤敏感，不能使用润肤剂	agreed
网传桃子和西瓜一起吃会致命 营养专家：没听说过	桃子和西瓜一起吃会中毒？年年辟谣还有人信	unrelated
一试便知:洋葱治疗膝盖疼痛效果极其惊人	膝盖疼痛——用洋葱治疗效果惊人	agreed
太原千峰北路发生爆炸了？太原网警公安调查结果！	#网警辟谣#科普【挖器官往事】！	unrelated
网传“峡山火灾烧死多人”事情真相是这样子的~	“湖南兰山县”烤火引发火灾 烧死5人 系谣言	unrelated
三丸阿司匹林+它洗头，不管“白”发有多野，3天黑似焦炭不染发	染发后如何洗头不掉色？八个秘诀让你发色持久有光泽！	unrelated
岳云鹏师弟狂损冯小刚，郭德纲发火台下指着就骂！好犀利	岳云鹏师弟狂损冯小刚，郭德纲发火台下指着就骂！	agreed
晚上夫妻生活等于慢性自杀？这个你一定要知道！	精辟-晚饭后这样锻炼等于慢性自杀？赶紧停了！	unrelated
48岁王菲近照，小腹隆起疑怀上第三胎？谢霆锋却开心不起来！	47岁王菲近照曝光，竟然已怀第三胎？谢霆锋的回复绝了！	agreed
威海人谁家里还有这种老缝纫机？发财了，价格比原来翻了50倍！	农民注意，家里有老式缝纫机的发财了，赶紧回家找	unrelated
民国九年袁大头市场价值	民国九年袁大头现在好不好出手？现在行情怎样	agreed
约女朋友出来吃大餐，点了8个菜其中3道海鲜，喝8瓶啤酒晕乎乎	你老公的啤酒肚可不是喝出来的！而是吃了它！你肯定不知道	unrelated
iPhone X 定制版曝光，颜值爆表，售价惊喜！	“开水烫死玳瑁”谣言背后的文化糟粕	unrelated
生吃这一常见蔬菜，防癌抗癌还养生	这6种蔬菜，轻松几步在家种，吃的放心还能防癌抗癌延寿	unrelated
吹风机如何神奇治病	奇闻！吹风机竟然能治病	agreed
茅台正式进入李宝芳时代 股票上涨5.60%!	茅台回应限产囤货提价传言：今年决不提高茅台酒出厂价	unrelated
央视都播了！60岁以下逮捕罚款，今天起全国严查棋牌室？	四川省公安厅辟谣：“全国将严查棋牌”是假新闻	disagreed
五五开首次承认小号开挂被封 但是我朋友测试外挂被封！	PDD为回应开挂谣言“出卖”老婆，沈灵敏这回要被“逼疯”啦！	unrelated
女生喝红糖水真的补血吗？百分之99的人都错了，男朋友注意了	超过40岁的男人，要警惕身体这9个告急信号！	unrelated
换了智能电表电费翻一番	自从换了智能电表后家里的电费就蹭蹭地往上涨，这中间有猫腻吗？	agreed
娱乐圈内幕：今年跨年晚会的3组“零点大咖”，谁接刘德华的班	谢贤说谢家的媳妇只有张柏芝，王菲别想进谢家！谢霆锋要哭了	unrelated
冯小刚说的没错，就是“垃圾”观众太多了！	冯小刚说的垃圾观众，在《演员的诞生》现场就有不少	unrelated
古墓里没有氧气 为何长明灯还能千年不灭？原因其实很简单	揭秘：在古墓里的“长明灯”为何千年不灭？其实它的原理很简单	agreed
农村的村干部应该有哪些人来当？看看国家出台的新规	郑爽恋情一直扑朔迷离，这次杨洋终于公开承认恋情了	unrelated
43岁林志玲再陷怀孕传闻，网友期待她和言承旭修成正果！	连央视都辟谣了，你还不信？居然说《致歉》没公章，是假的	unrelated
四川嬢嬢说：我用面粉洗出了“胶”……躺枪的怎么又是面筋？	衡阳辟谣“市长违纪被查”：已启动对谣言源头进行追踪	unrelated
烟王褚时健去世	别再传谣了，“烟王”、“橙王”褚时健活得好好的	unrelated
吴君如大点鸳鸯谱，古天乐终于与郭采洁公开恋情	又一对因戏生情的“国民CP”，古天乐郭采洁公开恋情了？	agreed
白糖蒸鸡蛋，一招搞定咳嗽	白糖蒸鸡蛋：一招搞定咳嗽（真神奇！）很多人都不知道！	agreed
吴京出家	战狼中的吴京没看够，你看看吴京出家的时候	unrelated
36岁玲花全家近照曝光，老公身价过亿，曾差点解散凤凰传奇！	房祖名带欧阳娜娜见父母，成龙：她是不错的女孩，章子怡都不敢怼	unrelated
太原千峰北路发生爆炸了？太原网警公安调查结果！	【辟谣】朋友圈疯传北海税局已经全国联网？经核实：假的！	unrelated
她身患癌症仍坚守岗位 比肩董卿	才华不输董卿，抗癌10年终返央视，今癌症复发瘦成纸片人！	unrelated
已生女宝，32周就已确定，给姐妹们分享下我的症状	给老公生了个小情人，女儿快两个月了，分享孕期症状，接女儿的进	agreed
最高法公布：醉驾可以免刑了！	醉驾可免处罚 ？年底了小心被谣言坑了！	disagreed
经纪人亲承博卡挖角特维斯 8月决定野兽未来	特维斯拿世界第一年薪却想着重返博卡，中超为何留不住大牌外援？	unrelated
三亚来了10000多个外地人,专偷孩子摘器官	胃溃疡竟因饭后这件小事？别在轻信谣言了	unrelated
又传结婚，网曝林志玲6月份将嫁上海富豪？	林志玲终于要结婚了，婚期在今年六月，网友：还是嫁给了富豪	agreed
朱之文决定离婚？妻子现场痛哭！	大衣哥朱之文决定离婚？妻子现场痛哭	agreed
刘涛三年内还清5亿债务，背后全靠贵人相助，能猜到算你厉害	刘涛丈夫欠款4亿，刘涛：不怕，有贵人相助，与贵人有这种关系	agreed
减肥很简单，一个月减25斤，每天只用7蚕豆，赶紧了解一下	港珠澳大桥大陆段有望元旦通车！	unrelated
新版寻秦记来了，吴奇隆客串，造型特效太雷人，古天乐看了要泪崩	吴奇隆称古天乐已过时，新版《寻秦记》受网友欢迎	unrelated
女人出现这些表现，铁定是在外“藏人”了，别不信！	“夜深了，女人有这三个表现，说明她在外面偷吃了，你懂吗”	agreed
歌手总导演洪涛将离职！歌手将没有下一季？	歌手停播？洪涛确认离开湖南卫视！下一个停播将是天天向上？	agreed
白头发拔一根长三根？神解释	白头发拔一根真的会长三根吗？你被骗了好多年	agreed
散户注意：股票一旦出现几种形态，满仓买入立马暴涨	只要遇到“双龙戏水”的股票，坚决买入，必定是一波暴涨行情	unrelated
农民注意了！农村这3类人的户口会被注销，土地也将收回？	户口迁出农村，土地就将被收回？政策是这样规定的，你知道吗？	agreed
最火的团队年终奖：王者荣耀团队年终奖：100个月的工资	王者荣耀年终奖100个月工资？腾讯辟谣了	unrelated
容易生男孩的女性有这几个特征，看看你有吗？	原来女性有这几个特征，将来更容易生男孩，看看你是吗？	agreed
张一山“抑郁症、将退出娱乐圈”？首次回应，暂时死不了！	爆张一山久病缠身，准备暂时退出娱乐圈，网友炸开锅了	agreed
5月1日起，全国公交正式成为中国失联儿童安全守护点！	网警辟谣 关于四平公交车成为失联儿童守护站的辟谣	disagreed
微博宣布退出娱乐圈，发文者并非朱之文本人	大衣哥朱之文发声明称退出娱乐圈，纯属谣言请勿信！	unrelated
橘子皮竟然能通过指纹识别解锁手机	手机密码忘了？教你一招，试试橘子皮这样解锁	agreed
吃芝麻 头发会变多变黑变粗 我会告诉你嘛?	吃黑芝麻能让头发变黑，发质越变越好吗？别傻了！	unrelated
成名后抛弃前妻娶小三的男星排行，冯小刚第三，第一名果然是他	赵本山最美女徒弟，成名后抛弃贾乃亮，嫁入豪门，如今豪车相伴	unrelated
「警情通报」网传平顶山市双楼乡麦田发生火灾系谣言	网传合肥森林海小区发生火灾系谣言	unrelated
网传潘长江女儿已去世，本人却突然发微博	潘长江发微博暗讽“能这么玩儿我也是服了……”辟谣“被去世”！	unrelated
农民工最真实的生活，希望你们能留下双击！	底层农民工的真实生活写照，黑油皮肤健硕身体撑起整个家庭的希望	agreed
《我的前半生2》将拍	张一山自曝生了很漫长的病，将暂别娱乐圈	unrelated
专家教你自制美白祛斑茶，睡前喝一杯，几天斑点暗黄都不见！	每天睡前涂一“小物”，三天皱纹全不见，皮肤白皙水嫩年轻十岁	unrelated
孕妇剖腹产时被医院偷肾？所谓“丧尽天良”，其实是旧谣新传	朋友圈传言来了个犯罪团伙 高青警方辟谣：假消息	unrelated
孙俪新剧曝光！演员阵容无比奢华 赵丽颖只能是个配角	孙俪新剧曝光！演员阵容亮瞎眼，赵丽颖竟甘愿自降身价做配角！	agreed
生男生女可以自己决定,日本黑科技成功率高达80%	农村的养肝“神草”，清炒、凉拌、泡水喝，败肝火，排肝毒更健康	unrelated
吃黑巧克力能减肥？这群嘴馋胖子真能骗自己！	很多人不知道吃黑巧克力的好处，减肥又降压，以后可以放心吃了	unrelated
柠檬水防癌	鹿晗的收入，王俊凯的收入，关晓彤的收入，简直是天壤之别！	unrelated
罗晋大方承认唐嫣已怀孕，迟迟不结婚，原因却是因为这个	朱之文退出歌坛以后于文华落泪惋惜，再度献唱《纤夫的爱》挽留！	unrelated
《前半生2》女主不是马伊琍，另换其人？	食物相克知多少？这四种水果一起吃危害大，你中招了吗？	unrelated
舒淇新戏杀青宣布退出娱乐圈，被疑和冯德伦造人成功！	41岁舒淇公开要退出演员生涯，网友：怀孕了？要养胎？	agreed
再也不用花钱买胶水了，做一次成功一次！	补肾食疗小偏方	unrelated
李湘跟谁有仇呀？把女儿王诗龄往啥方向教？叫姚明女儿农村娃	最新爆料：郭富城方媛被曝下月大婚，杨幂孕象十足，有好消息	unrelated
凤凰古城又收门票，游客会不会再次用脚投票	凤凰古城被爆再收门票，游客再便宜也不买账，商家无奈关门转让	agreed
抗流感药奥司他韦 沈阳药店大多断货	抗流感病毒药奥司他韦多地断货！国产药正在加速上市	unrelated
白皮鸡蛋和黄皮鸡蛋哪种更有营养？	白皮鸡蛋就是柴鸡蛋？就比红皮鸡蛋更有营养？	agreed
茶叶水加它洗头，多年白发，最快2天开始变黑，再也不用花钱染发	满头白发别花钱去染发，茶叶水加上它洗头，3天让你白发快速变黑	agreed
涂了防晒霜还是黑？这些物理防晒好物也不可或缺啊！	用了那么久防晒，物理防晒和化学防晒的区别你知道吗？	agreed
农民偷偷在水稻田养“黄金”增产又增收，年年都是几十万！	市场出售明胶螃蟹？实乃子虚乌有！	unrelated
用几毛钱治疗风湿骨病，这个妙招真不错！	专家妙招，治疗风湿关节痛有奇效，记得收藏	unrelated
刚被保释出来的高云翔就与粉丝合照，网友：太大胆	保释后首现身！高云翔顶光头穿紧身T状态很好	unrelated
农村的这6种房明年之前必须收回，你家房子在不在其中？	农村的这6种房明年之前必须收回，快看看你家房子在内吗？	agreed
刘强东：京东老员工在北京买了别墅，未来最赚钱的行业又要实现了	刘强东辟谣开除一半员工 我们还需要人	unrelated
微信中的养生：自来水未煮沸前放食物蒸煮会致癌，真OR假？	谣言：长期吃素能抗癌（已辟谣）	unrelated
《功夫2》被央视证实将开拍，男女主已定，周星驰不再参演成遗憾	周星驰将亲自参演《功夫2》电影？周星驰助理已对此作出明确回复	unrelated
伊利董事长“失联” 被指重大信息披露有问题	伊利回应“董事长被带走协助调查”：市场传言均为谣言	unrelated
常喝纯净水会得“软骨病”	手机号这几个数最多，3月后必有财运降临，不是升官就是发财	unrelated
啤酒都含多菌灵了？这个春节还怎么过	网警提醒：啤酒含多菌灵？这是四年前的谣言了！	unrelated
老贝：中资收购，我跟AC米兰永远在一起	AC米兰危机传闻漫天 但李勇鸿辟谣称一切正常	unrelated
此国被美国打得几乎亡国，反而最恨的是中国，最大的白眼狼，！	美墨战争中墨西哥几乎亡国，美国为何没有趁机吞并？	unrelated
“中国女首富”陈丽华的“身世”秘密终于被揭开，让所有人震撼	“揭秘”中国女首富陈丽华，那些不为人知的事，有钱不算什么	agreed
5角纸币是这种，现在价值720元，遇到别花掉！	5角纸币是这种，价值580元，一定别花掉！	agreed
腰腿疼痛，肩周炎，一把艾叶巧帮忙，多年腰间盘突出轻松搞定	腰间盘突出的朋友注意了，艾叶巧妙用法，告别多年腰腿疼痛！	agreed
女生校内遭流浪狗追咬，学校扑杀遭反对！出事了，爱狗人士，人呢	女生遭流浪狗撕咬：流浪狗该保护还是驱逐，甚或？	agreed
如愿生了男宝宝儿女双全啦，希望大家都可以家有儿女，附孕期症状	进来带走男宝症状吧，已生19天，有接必中	agreed
上海人挑柑橘还分公的和母的，看底下的圆圈就知道，母柑橘更甜	王菲怀孕流产 谢霆锋为王菲哭的视频曝光	unrelated
男翻女 接女孩的快来看症状，百接百中噢	男翻女竟真的发生在我身上了，总结一下症状，喜欢女宝的来接	agreed
孩子洗完澡半小时内，如果妈妈做“这些”，其实是在危害宝宝健康	孩子晚睡的危害及健康的睡眠法则，家长们知道吗？	unrelated
什么情况？贾乃亮公司删除声明，难道和李小璐真离婚了？	外汇局谴责“外汇管制”消息不实	unrelated
张伯芝订婚巴黎，成为他的女人，谢霆锋已经成为过去式	张柏芝订婚巴黎！等了谢霆锋那么久最终选择不等了吗？	agreed
毕福剑不断被传将回央视？明年春晚上能看到他了吗？	毕姥爷要重回央视,真的吗? 据传2017年春晚名单竟有毕福剑	agreed
张杰谢娜离婚成为事实？疑似邓紫棋插足？	最新消息：谢娜被爆暧昧男助理，张杰亲自出面辟谣	unrelated
廉价iPhone X确定：一半的价 不变的性能	4500元起？廉价iPhoneX真的有	unrelated
6分钟头发乌黑告别染发，不管白发多疯狂，用橘皮这样洗就OK了	震惊！央视一哥朱军继董卿之后也将退出央视，合唱一首歌万般不舍	unrelated
张柏芝与陈冠希同出大陆酒吧上演捞金，昔日金童玉女和好如初？	贾乃亮婚变黄晓明也接着出事？微博刷屏刷爆了	unrelated
斗鱼拖欠大主播工资？斗鱼：虎牙终于搞我了！	斗鱼被曝拖欠主播工资涉及百家经纪公司	agreed
罂粟治病	听说食用罂粟可治病 临沂八旬老人非法种植千株	agreed
浙江：职工医疗互助保障3年惠及46万人	慈禧本是和珅转世，和珅上辈子是皇妃，和乾隆上演宫廷版三生三世	unrelated
“夜宿故宫”女主播：很后悔，想向工作人员道歉	女主播称夜宿故宫还睡了慈禧的床？其实就是一场闹剧！	unrelated
吴昕追忆过往情史，面对粉丝称潘玮柏老公她这样回应！	吴昕啊，要找老公就找潘玮柏这种耳朵藏不住秘密的男人吧	unrelated
榴莲不能和什么一起吃 榴莲的食用禁忌	吃了榴莲别喝酒 可能会引起酒精中毒	agreed
福建高校发展潜力排行榜出炉！填报志愿、选择专业时的重要参考！	「辟谣」河北17所本科高校转为职技学院？假消息！	unrelated
《权力的游戏》第八季2019年上映 系列迎来最终章	《权力的游戏》第八季将在2019年开播	agreed
相恋十周年，难道出现感情危机？谢娜清空张杰微博	删张杰微博？谢娜：看到某些言论很难过，以后不再分享感情	agreed
比毒蛇还毒！清明节前后，红心甘蔗不能吃！	辟谣丨“清明甘蔗比毒蛇还毒”，到底怎么回事？	disagreed
男子来到巨人国，向他们演示炸药的威力	男子来到巨人国，参观他们的菜市场	unrelated
严重警惕：威胁孩子健康的18种食物 否则，吃的越多危害越大！	健康辟谣：鸡蛋内含有大量胆固醇，中老年人不宜食用？	unrelated
范冰冰晒近距离自拍，遭网友吐槽：照片暴露了整容的痕迹？	整容女说现在是年轻人的时代了，范冰冰都没得比，毕竟老了	unrelated
喝汽水会引起骨质疏松？	打破谣言！碳酸饮料容易引起骨质疏松的说法真的对吗？	disagreed
梅姑死后，刘德华唱给她的一首歌，很多80后，90后都没听过！	刘德华最疯狂的一次，当街连杀四个人，而且每个死法都很古怪	unrelated
早晨吃姜有3大奇效 为何晚上吃毒似砒霜？	晚上吃姜毒过砒霜，以后晚上还能不能愉快的吃姜了？	agreed
农村田边有种野菜，碰断竟会流出乳汁，却是抗菌消炎抗癌的良药	这种农村里的野菜，已经很少见了，它们抗癌功效特别好，知道吗？	agreed
呼和浩特1月20日起抓拍 不系安全带	【曝光台】这不是谣言！开车不系安全带高清抓拍曝光	unrelated
老年斑最大的克星问世了 还在为祛斑着急的你 抓进来了解一下吧	药店角落里的“它”，堪称老年斑“克星”，祛斑效果堪比换脸	agreed
苦恼白发和脱发？喝水时放几粒它，不用吃药染发照样还你一头黑发	花生和它一起熬着喝，防脱发治白发，让你到了60岁也不用染发	unrelated
女人不想过早变老？平时多吃这三种水果，美容养颜还调理更年期	聪明的人喜欢吃它，清肠排毒、美容养颜，爱美的女人不能错过！	unrelated
牛人自制永动机，这机器的构造也太巧妙了吧！谁能找出破绽？	民间牛人自制永动机 这是什么原理	agreed
最健康的3种小零食，不只好吃，对身体健康也有很大好处！	杨幂证实确实离婚，看背后是谁给了她这么大的背景	unrelated
人体并没有排毒时间表，心好痛，以后再也没有借口早睡觉了	还相信“人体排毒时间表”? 专家都辟谣啦！	unrelated
晚上吃它等于慢性自杀，第一个你就经常吃！	晚上吃它等于慢性自杀，第一个你就经常吃！为了孩子，还不快看！	agreed
微信重大更新，个人微信号账号可以修改了	喜大普奔！微信号可以修改了 嫌弃的不行的微信号可以换了	agreed
拿洋葱加它放水里洗头，在严重的白发，3分钟黑如木炭！	洋葱加它洗头，再顽固的白发，七天就能乌黑浓密，从此告别染发剂	agreed
广西南宁大草坪上打小三视频	深圳要建第二机场	unrelated
“百辆军车入驻农安一中学等待震后救援” 散布谣言者被拘留7天	中酒协回应啤酒甲醛超标传言：属造谣传谣的违法行为	unrelated
2017土地新政策出台，今后农村用地将变得更加紧张	2017年农村新政策出台，有两大类的房屋将被回收处理！	unrelated
七岁女童白血病入住儿童医院，专家提醒，小心儿童这四种症状	化学博士辟谣，甲醛导致白血病？终于有人站出来说实话了	unrelated
6月起，五险一金将变成六险二金，工资会下降吗？	“五险一金”变“六险二金”？朋友圈疯传社保新政，人民日报辟谣	disagreed
海关数据暂停更新，中国外贸出了大问题	“海关数据暂停更新，中国外贸出了大问题？”紧急辟谣！	disagreed
2017年广东本科大学有哪些 2017广东十大本科学校排名	2017年海南十大本科学校排名	unrelated
忘带驾驶证开车，属于无证驾驶吗？扣多少分，怎么罚？	开车出门忘带驾驶证，到底算不算无证驾驶，碰到交警该如何应对？	unrelated
农村一男子在野外捡到好多奇石，砸开后一看，乐笑了	湖南新化回应村民组队上山“挖宝”：石头无价值有人散布谣言	unrelated
夏天在家搁条它，家里蚊子苍蝇老鼠都没有，搂着它都不用开空调	家里有小宝宝夏天不能开空调？这些带娃谣言别再相信了	unrelated
洪涛将离职湖南卫视：自古人才留不住，唯有套路得人心	《歌手》总导演洪涛离职 或将加盟视频平台	agreed
南阳发生伪装冷饮车偷小孩事件	辟谣！网传南阳发生“伪装冷饮车偷小孩”事件，真相来了！	disagreed
崔永元不惧范冰冰警告再爆猛料，原因是范冰冰的一句话刺激了他	为何王思聪不喜欢范冰冰？原因竟然是为了43岁的她	unrelated
吃西瓜感染H7N9？男子为让西瓜卖便宜点儿散布谣言	散布地震谣言者被确山县公安局依法行政拘留	unrelated
明察｜四川宜宾警方：“枪击爆头视频”是拍电影，非枪击案	宜宾网警辟谣：网传“南岸一小孩差点被陌生男子拐卖”系谣言	unrelated
交警提醒：驾驶证加分政策正式实施，每个记分周期最多21分！	手机边充电边使用会爆炸	unrelated
从北向南 全国高校王牌专业大盘点！	福建高校发展潜力排行榜出炉！填报志愿、选择专业时的重要参考！	unrelated
为防感冒半夜熏醋 一家三口呼吸困难	网传在房间里煮醋，靠熏醋就能预防感冒，这种方法靠谱吗	unrelated
张卫健父亲家暴出轨，获刘德华张国荣救济，和谢霆锋打人被封杀	张卫健辟谣什么 事件来龙去脉曝光一个举动被传吸毒	unrelated
南昌高楼大火，多人梦中被火化？视频中分明听到说外语	网传唐山市玉田县民房火灾视频均为谣传	unrelated
疑似卓伟公开表态”黄毅清所爆料的非常具有真实性“	马苏糟了？卓伟爆料黄毅清言论真实，PGone现状乘车返乡	agreed
张靓颖被爆新恋情，新男友曾是自己婚礼的伴郎，这关系有点乱！	有媒体爆料张靓颖疑有新恋情，男方是其与冯轲婚礼上伴郎之一	agreed
周润发因病去世-发嫂说大吉大利发哥很好	网传周润发已经因病不治去世了，粉丝们心痛死了	unrelated
古钱币今年更方便快速出手	古钱币出手哪里可以快速交易？	unrelated
中国股市再现十字星，黑周四或将暴涨逆袭：保利地产 华夏幸福	芯片又一龙头横空出世，利润暴涨190倍，或将碾压华峰股份成妖	unrelated
女子香水太浓，竟触发高铁火警，停车3分钟！	香水把高铁“逼停”了……	agreed
温岭洞下沙滩有人被鲨鱼咬伤	马云称2018年机会给你了，你再不把握，注定变成困难户！2	unrelated
老中医：比薏米祛湿邪好一百倍的“宝贝”轻松横扫体内10年毒	比薏米祛湿好一百倍的“东西”轻松横扫体内毒	agreed
熊乃瑾疑似怀孕，都提王宝强，熊乃瑾回应两人关系	熊乃瑾戴黑色口罩，腹部突起现机场，网友直呼王宝强：你真厉害！	agreed
不吃饭就能瘦下来？这个方法让你7天瘦9斤，其实减肥没有那么难	晚上不吃饭就能瘦下来？这个方法让你8天瘦12斤，减肥一定要看	agreed
春茶中含过量农药？	茶叶喷农药一喝就中毒 安徽食药监辟谣	unrelated
甘姿观察：苹果减肥法风声水起	酸奶苹果减肥方法	unrelated
《逐梦演艺圈》导演说《寻梦环游记》抄袭他，网友却支持他去起诉	《逐梦演艺圈》导演毕志飞给大片差评，网友：看哭了！	agreed
微信支付宣布：提现免费，网友：又没我什么事	速看！微信可以免费提现了！	unrelated
牙膏洗脸小窍门，几天就变白，赶紧学习一下	大妈用牙膏配它洗脸，大片斑点全不见了，酷似十八岁，皮肤白净	agreed
持枪藏毒案：周立波成唯一被告！在美国坐41年牢，凶多吉少？	周立波判刑41年，前妻早有预料？多篇文章细数周立波十大罪证！	unrelated
怎样用生姜治疗脱发 生姜的功效与作用	生姜真的可以治疗脱发吗？这些细节要注意	unrelated
一招解决脚脱皮儿 脚臭脚气 3天有奇效	张召忠：马六甲海峡三国与美国结盟必然爆发战争！	unrelated
狗年，狗成精会说话了	看狗狗会说话	agreed
农民大哥为了家人捡吃捡喝，一餐只吃一碗米饭一碗白开水，好心酸	农民工大哥为了家人捡吃捡喝，一餐只吃一碗米饭一碗白开水	agreed
不给孩子打疫苗？不好，这名家长莫非是感染了SB250病毒	醴陵有人感染sb250死亡_	unrelated
关晓彤敢自曝非李易峰不嫁，娱乐圈独她一个	国民闺女关晓彤直言要嫁李易峰 李易峰面对表白给出了这样的回应	unrelated
微信悄悄出新功能！网友：千万不能让女友知道……	生活妙招：大部分人不知道微信这项强大功能，可以让骗子无处藏身	unrelated
传说中有种“负卡路里食物”可以不运动就瘦性大发？	越吃越瘦的「负卡路里食物」竟然是它？	agreed
张柏芝竟想将儿子改姓，谢霆锋不回应，谢贤因一原因不介意	锋菲恋告急？张柏芝想为儿子改姓，谢霆锋却想要回家了！	unrelated
肚子一抓一把肉？7天瘦下来，每天一片生姜，连便秘湿气也好了！	肚子一抓一把肉？只需一片生姜、用几个瘦几个/连湿气便秘都好了	agreed
半路杀出33亿身价“曹操”，范冰冰李晨婚期无望，李晨怂了？	范冰冰李晨遥遥无期的婚礼，半路杀出了身家33亿的“程咬金”！	unrelated
关于开车用车的七个谣言，你一定听过！	空档滑行只为省油？这些省油谣言你别再信了！	unrelated
加工牛奶连小牛都不能喝，否则会死亡	薛之谦与前妻高磊鑫复合 网友喊话胡歌薛佳凝求复合	unrelated
国家免费给你一套120平米大房子，你愿意放弃农村，搬迁吗？	农村65岁以上老人免费体检，国家政策如此好，厉害了我的国	unrelated
王鸥“小三“传闻现身 称没有的事 问心无愧	刘恺威被爆出轨小三王鸥	unrelated
生姜又双叒叕搞事情，用它洗头，12年白发3分钟乌黑如墨	成实外教育又双叒叕出来辟谣！声明与某在线教育平台无任何关系？	unrelated
实录：UFO最真实视频大集合 -国语流畅，外星人真的存在	减肥期间肚子总饿怎么办？换种新吃法，快速控制食欲	unrelated
微信新功能，可以免费上网，只需这样设置下微信	微信这个功能可以免流量上网，只需打开微信这个地方	agreed
今年苹果丰收，但价格却暴跌，一斤不到3毛钱	苹果价格暴跌	unrelated
男人喝豆浆好处 喝豆浆能有效防治哪几种疾病	辟谣：男人不能喝豆浆？	unrelated
希特勒疯狂屠杀犹太人的原因，竟和他母亲有关？	希特勒为什么屠杀犹太人？背后原因其实很复杂！	unrelated
中华民国九年袁大头市场价格	袁篇（卅二）袁大头民国九年一元银元中发和精发版别	unrelated
微信聊天记录删除了还能看到吗？如何彻底删除微信信息，来看看吧	微信聊天记录删除了还能找回？其实很简单，可惜知道的人不多	unrelated
王思聪上节目表白赵丽颖称会一生守护她 林更新吃醋这样回应	王思聪的熊猫TV回应资金链断裂传闻—那是谣言，我不差钱	unrelated
吴亦凡被曝吸毒，受访期间摇头晃脑	吴亦凡公开回应吸毒谣言：昨天的误解，还是觉得挺无辜的	disagreed
好消息，2017年新农合新增五项补贴，农民速速申请！	新农合又有大动作，农民看病新增5项补贴，农民都可以领取！	agreed
农村留守妇女和孩子为什么害怕在外打工的丈夫突然回来？	农村留守妇女为何害怕老公突然回家？	agreed
国家出大招，“揪出”农村10万个贫困户，贫困农民的福音！	微博辟谣 国家精准扶贫发钱啦！假的！	unrelated
南昌省政府大院旁煤气爆炸。减肥养生招商15933068468	南昌重大煤气管道爆炸，不比911场面差多少。。。	agreed
伊利发声明：董事长潘刚身体仍在治疗恢复，无法出席博鳌论坛	刚刚，伊利股份回应称：市场传言均为谣言！！	unrelated
莫雷诺亲承考虑离开申花：已收到其他球队邀请 足协杯后定去留	李建滨辟谣转会传闻：只要申花需要，我就不会离开	unrelated
朱之文被村人唾骂，搬家时为村民最后唱了这首歌，全村痛哭流涕	朱之文被同村人唾骂，搬家时为村民最后唱了这首歌，全村人哭了	agreed
欺骗我们多年的人体排毒时间表！网友：还能不能好好过日子	欺骗我们多年的人体排毒时间表，背后竟然是	agreed
以前的2角的硬币，现在值多少钱？	家里的一分硬币现在值多少钱？	unrelated
力压章子怡夺校花，和刘涛同嫁豪门，胡静却深陷整容门、婚变门	刘涛婚变	unrelated
刘亦菲曾为干爹堕胎？女神级人物形象崩塌，是炒作还是确有其事？	神仙姐姐刘亦菲被曝做过变性手术和堕胎两大事件，真实原因是什么	unrelated
夏季的这两大水果一起吃不仅没营养，多食还有害健康，少吃为妙！	你还在吃草莓、西瓜？反季果蔬真的有害健康吗？	unrelated
杨幂游戏账号曝光，职场人可以学ab倪妮玩英雄联盟LOL解压！	杨幂撩电竞圈大神引迷弟醋意大发 网瘾少女游戏账号遭曝光	unrelated
市教育考试院提醒：高考季网络谣言别中招	辟谣！朋友圈频繁转发捡到准考证纯属谣言	unrelated
45岁以上农民注意，新农合新增5项补贴，你都拿了吗？	号外，2017年新农合新增五项补贴，农民速申请！值得一看	unrelated
奶茶妹妹的前男友曝光，是帅气才子？却因这个分手选择了刘强东！	同时删微博，难道刘强东奶茶妹分手了吗？2	unrelated
林更新与王丽坤的恋情坐实了，两人的这个小细节出卖了他	继赵又廷曝林更新与王丽坤恋情后，又一证据，说明两人在热恋中	agreed
2017年黑龙江玉米大豆生产补贴有消息了，9月底前全部发放！	农户注意啦！“严禁浇地，违者罚款，发放种植补助”纯属谣言！	unrelated
严查！郑州一面包车里塞了13人 驾驶员被罚200元记6分	【辟谣：郑州园博园8月15日试运营未经核	unrelated
你身边的天然降压药终于来了，每天吃点，血压偷偷稳降	血压高得干不了活？这些不起眼的食材每天吃点，血压稳降身体棒	agreed
艾草一把，专去腰间盘突出劲椎痛，实用简单又有效	腰间盘突出疼起来要人命！使用艾草来解决，腰疼腿麻脚麻都管用	agreed
山西五台山，有假和尚黑导游，五一旅游防止被坑骗，不要贪小便宜	辟谣丨五台山佛光寺要维修 还要封闭修十年？	unrelated
与糖尿病共度42年 民间“天然胰岛素” 用这方法摆脱药物	患糖尿病11年 每天来点天然‘胰岛素’ 谨防糖尿病6大并发症	agreed
受伤的不是鲁能女球迷，就能掩盖国安某些球迷的真实素质？	Uzi是队霸？RNG无心回应骂小狗毒瘤：都是引战谣言	unrelated
2018年开始，农民禁止在田里做这5件事，违者就受到国家重罚	朱之文被同村人唾骂，搬家时为村民最后唱了这首歌，全村落泪！	unrelated
冯小刚称看不懂《战狼2》，网友们愤怒骂冯，各种骂法多种多样	刚刚《战狼2》票房破40亿，冯小刚直呼看不懂大陆的电影市场	agreed
三高最怕这种酒，每天一杯高血压高血脂一扫而光！	重磅利好：乙肝神药研发成功，华为借壳医药龙头上市获批，十连板	unrelated
毛宁，入狱后杨钰莹含泪唱出这首歌，唱哭毛宁	音乐：毛宁入狱，杨钰莹为他唱了这首歌，太感人了	agreed
《权力的游戏》官方终于确认，第八季会在 2019 年回归	HBO确认《权力的游戏》第八季最终季将于2019年回归！	agreed
网传视频：临天八弄砍死人了	烤色蜜蜡=假货被证实为谣言，别再传了！	unrelated
93、97号汽油明年起退市 国Ⅳ标准汽柴油成历史	四川93号97号汽油即将退市	unrelated
李小璐小腹隆起，这是怀上二胎了？	网爆李小璐怀二胎？那么问题来了，孩子究竟是谁的？	agreed
夜市5000淘到的翡翠原石，莫西沙表象，切开后价值几何	百万级莫西沙翡翠原石，13公斤冰种！切开后能否暴涨？	unrelated
公交车坐垫上面安装针头 针头上有艾滋病毒	共享单车坐垫藏针头？警方来辟谣言！	unrelated
关晓彤被曝因缺课过多将留级 或与王俊凯成为同班同学	院长亲自为关晓彤辟谣“留级”事件，直言艺术教育得因材施教	disagreed
监控拍下的鬼镜头：吓死人不偿命，你敢看吗	中国古老传说鬼是没有影子的，接下来监控拍下的这些你信么？	unrelated
网传年近五十吴奇隆没有生育能力，刘诗诗已和他离婚！叹息……	古玩收藏之铜元篇——江南省光绪元宝铜币价格大全 （中）	unrelated
南宁新和平商场夫妻吵架妻子跳楼身亡	南宁一托儿所有鳄鱼从天而降！真相竟是……	unrelated
小沈阳被赵本山怒斥一顿 接赵本山电话打哆嗦 7	小沈阳被赵本山怒斥一顿 接赵本山电话打哆嗦 4	agreed
1角纸币如果是这样的，遇到了一定要收藏，已经升值很多了。	嘻哈一族：纸币升值了！1角纸币价值3万5, 赶快回家找找	agreed
《我们相爱吧》第四季即将开播，郑爽赵丽颖CP令人期待	郑爽赵丽颖参加《我们相爱吧》，一男嘉宾背景神秘，他们如何组队	agreed
50米长的巨蛇，爬上高楼，一口把直升机咬了下来！	50米长的巨蛇，爬上高楼，一口把直升机咬了下来！太凶悍了！	agreed
每天喝它，相当于吃10个苹果，能降血脂、降血压、降血糖！	一种菜叶子，能治胃痛能降血压去结石，你今天吃了吗？	unrelated
教师的绩效工资制度是否需要改革？	教师30%绩效工资归个人，另均增万元，可怎么分配？却犯了难！	unrelated
吴昕春晚节目被砍遭众好友安慰 离开快乐大本营吴昕还能去哪？	吴昕离开《快乐大本营》，主持新节目，气场十足完全变了一个样！	unrelated
“地震云”到底能预测地震吗？	九寨沟地震前现“黑鸟乱飞”异象？省公安厅：谣言	unrelated
162斤减到96，自制瘦身茶，睡前来两口，减肥不求人	171斤减到107，自制减肥饮，饭后喝2口，刮油消脂瘦全身	agreed
周杰伦1.2亿豪宅再被曝光！昆凌晒顶楼360度观景台	周杰伦1.2亿豪宅再现	agreed
医生讲：吃香椿前要先焯水，否则会亚硝酸盐中毒，易致癌！	抓住春天才能品尝到香椿的味道，过了这段时间食用就有致癌的危险	unrelated
娱乐圈的坑娃神爹，除了贾乃亮当属他！别说，儿子还和甜馨挺配	高曙儿子找不媳妇愁娶了媳妇还愁说儿子太软弱，贾乃亮不服气！	unrelated
净网2018「揭西警讯」揭西公安机关依法处置一宗谣言案	网警辟谣：“首长路过广西豆腐渣街道”为虚假信息	unrelated
毛孔跟蜂窝一样粗大？洗脸加这一物，皮肤不出半月就变得水嫩嫩的	啤酒和它混合敷脸，坚持7天，皮肤年轻20岁，毛孔粗大消灭了	unrelated
微信群传播安新县留村有偷小孩的视频系谣言	张家口“王家寨来了一个偷小孩的”系谣言	unrelated
兴化荻垛发生一偷小孩事件 嫌疑人被群殴后已送警	小孩装纸箱丢弃？泉州网警巡查执法官微：谣言	unrelated
一招解决口气，口臭，口腔溃疡，三天就好	口臭、口腔溃疡怎么办？教你一招不用去医院，解决所有口腔问题！	agreed
“解放军澳门杀人”？澳门政府气急眼了，直接出面！	政府辟谣雾炮车作弊 为何民众依然怀疑	unrelated
“牡丹江二院门口杀人”？谣言！	辟谣：“十八仔水库捞出一条530斤草鱼”系谣言	unrelated
内蒙古锡盟东乌旗发生地壳推移 大自然真是不可抗衡啊	官方辟谣：内蒙古发生“地壳推移灾难”了？跟我来找茬！	unrelated
今年起农村这3项补贴将直接发放到每家每户，没村干部啥事儿了！	13个民间偏方教你脚气怎么根治！简单实用！	unrelated
世界最高薪！曝山东鲁能年薪2.44亿请温格执教	谣言！鲁能官方发微博辟谣，幽默回应有“李教授”这位鲁能版温格	unrelated
李念离婚	瘦身达人教你自制花叶减肥茶，好喝又健康，速效不伤身	unrelated
李小璐霸气自爆整容，竟声称：怀孕时，在肚子里给宝宝也整了容	李小璐父亲节晒照，破整容谣言！儿时就美如画中人	unrelated
传闻吴亦凡哼唱歌曲吸毒，吴亦凡工作室发声明讨说法	恒天然回应“恶意收购贝因美”：已要求贝因美调查不实传闻出处	unrelated
共享单车ofo余额无法退回，摩拜ofo押金退还问题谁在遮	人民网辟谣 摩拜与ofo押金无异常	unrelated
中国将申办2030世界杯？	皇马官方辟谣：并未报价姆巴佩	unrelated
朱之文被同村人唾骂，搬家时为村民最后唱了这首歌，全村落泪	朱之文被全村人唾骂，搬家时为村民最后唱了这首歌，听完全村落	agreed
中山有人吃西瓜感染SK5病毒	“SK5病毒”又来祸害西双版纳？谣言！谣言！谣言！	unrelated
全国严查棋牌室，一律逮捕罚款？我差点就信了……	谣言！网传南山竹海拍抗日剧招群演，装死也有300元？	unrelated
女星长相像章子怡，因这事被张国立儿子张默殴打！	62岁张国立近照，光头谢顶走路需人搀扶，提起儿子张默抱头痛哭	unrelated
QQ聊天记录删除了怎么恢复？苹果手机QQ聊天记录找回技巧	手机QQ要凉？官方紧急辟谣：服务器波动	unrelated
上海之后，深圳也暂停投放共享单车：已经89万辆了	深圳新能源车不再免摇号上牌？深圳交委：谣言！	unrelated
澳洲宣布：马航MH370找到！失联前遭枪击，残骸布满子弹孔！	失踪至今4年！澳工程师称找到马航MH370 残骸满是弹孔	agreed
31岁赵丽颖做手术，男友全程陪伴，网友：终于现身了	每天睡前扭一扭，排宿便刮油脂，大肚子变成小瘦子	unrelated
大咖头条 出轨大戏再次上演！杨幂婚姻遇危机 刘恺威出轨	【谣言粉碎机】开水冲蛋吃出白血病？简直危言耸听！	unrelated
王菲再出名言回怼张柏芝，只因张柏芝这样评价了窦靖童！	王菲谈张柏芝怒怼记者，句句都让记者哑口无言！	agreed
网传“太和县学生失踪，肾脏被偷”为谣言	四个和尚偷肾？这么老的谣言套路也有人信，还闹得人尽皆知？	unrelated
可乐加牛奶会发生什么，终于明白结石怎么来的？看完再也不想喝了	健康小科普：碳酸饮料喝多了易患肾结石	agreed
张柏芝欲将孩子改姓张？谢家人的反应令人意外	一方改名是谣言！	unrelated
「白頭髮」竟然有解！八個食療小偏方沒幾天全黑回來了！	谁还花钱去染发呀！厨房里的这2种食材抹一抹，3天白发变黑发	unrelated
二两白醋夹两物洗头，多恶的白头发，2刻润如乌墨，一生无需再染	白醋夹两物洗头，多恶的白头发，2刻钟乌润如墨，一生不需再染	agreed
事业单位工资涨了吗？这里告诉你！	辟谣更正：NBA发展联盟球员并非每个月涨薪7000美元	unrelated
白酒的死对头，酒前偷偷吃两粒，喝不倒灌不醉酒后不头痛护肝保胃	想要千杯不醉，越喝越能喝？酒前吃两粒，喝酒霸气！宿醉还不头痛	agreed
冯小刚对《战狼2》票房高表示不理解	冯小刚说看不懂战狼2票房，网友：是你所有电影票房总和！	agreed
21日开始执行！深圳高峰期外地车限行区域扩大到全市	「警示」“广州10月21日外地车限行”是谣言！男子造谣被行拘	unrelated
湖南这三座城市合并，将会超越上海成为第一大城市	湖南撤销地级株洲湘潭两市升格长沙市为谣言	unrelated
莆田金店老板大白天遭歹徒持刀抢劫	莆田金店老板哭了，大白天遭歹徒持刀抢劫……一年都白干了！	agreed
“专升本”考试作弊 7名考生成绩取消	政府辟谣雾炮车作弊 为何民众依然怀疑	unrelated
大妈60岁都不长斑点皱纹，就因洗完脸后，常涂抹一粒小小它	蜂蜜加它抹脸,50岁难有皱纹,祛皱胜过做激光,不学可惜了	unrelated
俄罗斯间谍潜入美军基地，传出大量UFO视频6	俄罗斯间谍潜入美军基地，传出大量UFO视频2	agreed
农民朋友注意了，2017农村宅基地新规：这几类宅基地将被回收	下半年农村这4种宅基地将面临回收，农民们要做好准备！	agreed
传C罗通牒皇马：给我梅西一样的薪水！瓜帅欲购曼联目标中场！	足球界开始流行辟谣？西媒报贝尔无意离开皇马！	unrelated
房产证下岗，不动产登记实施一年多，南昌人竟然还没搞懂这件事	"郑州办理不动产竟收""加急费""？ 系无良中介圈钱伎俩"	unrelated
孟美岐贴吧约人一夜情	张翰公布新恋情，女友眼神犀利气场十足！网友：郑爽娜扎没戏了	unrelated
李双江梦鸽之子李天一提前6年出狱？	李天一提前六年出狱？北京监狱辟谣称其仍在服刑	disagreed
卫生组织鉴定：全身致癌的3种蔬菜，赶快告诉家里人	为了健康！这样的蔬菜就不要吃了！有致癌风险	agreed
菠菜和它是绝配，女人多吃美容养颜，还健身！	夏天养生水果，每天吃一个，美容养颜，减肥瘦身，女人最爱它	unrelated
据说左手食指上有伤疤的人，那是上辈子最爱你的人留下的印记，	滨州还没考驾照的人要哭了！4月1日起，驾考将有重大变化！	unrelated
潘阳去世了？潘长江祈求网友心疼做父亲的心酸吧	传闻横条纹只会显胖，这种谣言别再信了！	unrelated
经常熬夜会猝死吗？怎么才能把觉能补回来？	辟谣！程序员才不是一个高危猝死的职业！	unrelated
爆脾气的韩红体重成谜，却一直拒绝体检，不小心说出理由让人泪奔	韩红希望自己能活久一点，但始终拒绝做体检，到底怎么一回事	unrelated
四川一男子持刀刺伤4人	谢贤要把遗产交给自己的两个孙子，网友不管怎么说他们都是谢家人	unrelated
秦俊杰袁冰妍举止亲密	赘肉再也不难减，自制一杯水：连喝2月排尽3年毒，体轻肚腩不见	unrelated
用4000流明灯光微距镜头下显示出的北京雾霾	微距镜头+4000流明灯光下的雾霾 大家出门一定都要戴口罩	agreed
减肥瘦身光减食，不是较好的选择，这几项有氧运动，快速暴瘦	韩国郑多燕减肥操7天瘦8斤健身操快速减肥	unrelated
老年代步车，任性上路，乐清交警大队坚决查处	“三无”老年代步车一律不得上路行驶	unrelated
市交警支队机动车“交通违法清零”行动正式启动	辟谣！武平交警发表声明：处理交通违法暂无新的规定！	unrelated
林依晨近照气色不佳面部凹陷，被疑厌食症	林依晨患厌食症？双颊凹陷气色差	agreed
王思聪2千万签下古力娜扎和赵丽颖，用2亿都签不下她	王思聪3千万想签约赵丽颖做代言人，神秘男直接替她拒绝！	unrelated
常州家庭困难的应届大学生可领2000元的秋季助学基金	辟谣：低保户学生上大学一年补助一万元？假的！	unrelated
国家为了农民安全，全面禁止农村电动车上路，为啥有人还要偷骑？	"普京骑熊""霸气照网上流传？亲口辟谣：我没骑过"	unrelated
午睡等于慢性自杀？不是所有人都能午睡的，这7种人要注意	运动后饮水不当等于慢性自杀	unrelated
“塑料粉丝”反复炒 看招远如何破	「辟谣」“紫菜是塑料做的？！”这则谣言事关晋江100多家企业	unrelated
权威辟谣！疯传的“太原限购”是假的！请勿传谣！	网传济南将取消限购？假的！这是谣言……切勿传谣！	unrelated
周星驰《功夫2》证实即将开拍，吴孟达马云有望出演	《功夫2》开拍竟是谣言！可惜大屏幕上看不到马爸爸了！	unrelated
农村赶集时常见的3种零食，5块钱吃到饱！如今快要消失了！	辟谣：这个所谓“年货大集”与雷蒙团队无关！	unrelated
朋友圈盛传15日-25日飞机撒药治白蛾 沈阳市林业局：假消息	谣言终结：近期飞机撒药治白蛾，应减少外出？	unrelated
王思聪喊话那英滚出娱乐圈，网友纷纷认同王思聪的做法！	王思聪对那英放狠话：总有一天让你滚出娱乐圈	agreed
网传视频杨梅被注胶?24岁小伙子吃杨梅肠子被割破?	白头发太疯狂？阿司匹林加这样洗头，3分钟黑似墨水，不学真可惜	unrelated
湖南常德领导参加被查的伊思多尔公司的剪彩仪式	餐桌上的它居然是抗癌之王，营养丰富味道好，许多人却不爱吃	unrelated
疑似赵丽颖结婚照流出 网友直呼：太不般配	171210 赵丽颖被质疑脸太肿 现场工作人员极力辟谣	unrelated
扫码缴纳违法停车罚款？千万别，扫一扫你就上当啦	河北交警辟谣朋友圈兜售车牌靓号:假的,不要上当!	unrelated
穷人的机会来了，2018抓住这五大行业，傻子都能赚钱！_1	穷人的机会来了，2018抓住这五大行业，傻子都能赚钱！_7	agreed
给力！“丘北有三人感染sk5病毒”传谣者已被拘留	辟谣｜朋友圈的谣言老朋友：sk5，又来了！	unrelated
古币市场开春依旧火爆，袁大头又拍出200万高价	卓伟深夜再爆猛料，原来毒哑王杰的不是谢霆锋，网友：卓伟别扒了	unrelated
张柏芝与小男友何孟怀即将大婚，谢霆锋心酸回应：她过得好就好	张柏芝即将大婚，现场含泪为男友唱了这首歌，谢霆锋台下掩面流泪	agreed
北京昌平区东小口镇发布驱离租房人员“紧急通知”	用蚯蚓钓鱼落后了！教你用大蒜钓鱼，鱼获双倍让你满载而归	unrelated
秋冬季节吃柚子，好处多多，但千万别和这7种药同吃，严重会猝死	柚子跟药不能同吃会猝死？那还能不能愉快的吃水果了？	unrelated
范冰冰真正的靠山，成龙都畏惧三分，李晨都不敢牵手！	范冰冰真正的靠山，成龙都畏惧三分，李晨都不敢牵手	agreed
火箭西决出局之后获好消息，白菜价获得第三巨头，明年总决赛见！	霍金预言：1000年内地球将会毁灭！	unrelated
王祖蓝为爱妻退出娱乐圈，只因李亚男患抑郁症！网友大赞好男人！	李亚男患抑郁症实属谣言，王祖蓝今日发文辟谣	unrelated
学习了！洗头的时候加点它，3天白发变黑发，7天乌发黑如墨！	白发别再花钱染了，用“它”洗头，白发7天变黑发，永不反弹！	agreed
湿气重的人，3类食物别贪吃，容易让“湿气”越吃越重	螳螂吃丈夫是谣言？真实原因只是因为它们贪吃	unrelated
“菊花一角”只收不付，存量大，却值钱，不能不收藏	正品收藏：菊花一角不是不值钱，而是值钱的你不可能有	unrelated
微信官方发布的，恢复微信聊天记录教程	分享你们平时看不到的远程微信聊天记录恢复操作-远程580	unrelated
杨紫被爆料曾和霍建华交往还怀孕了？亲自回应获网友点赞！	景甜辟谣，回复：假的，我发胖了，拍戏没有时间	unrelated
女生吃槟榔会导致不孕吗，女生吃槟榔的好处和坏处	槟榔能致口腔癌？谣言止于智者！	unrelated
美白小窍门，教你快速白起来，拒收80%的人都不知道……	欧赛媤每天快速美白的5个小方法	unrelated
2018中国大学综合实力排行榜1200强，北京大学蝉联榜首！	最近双一流大学名单在网上谣言四起。其中除	unrelated
明天起：汽车年审新规正式施行，将取消5项收费！车主互相转告！	11月起：汽车年审新规施行，将取消5个收费项目！望互相通知！	agreed
Angelababy 陷入“代孕”门，到底是真是假？	Baby是不是代孕？这几张图就能让谣言不攻自破！	disagreed
桐乡老东兴商场即将倒闭	A级、B级、C级驾驶证的“年审”新规定(2017)！	unrelated
基因真能算出人的 死亡时间	死亡基因告诉你!死在未来某一天的上午还是下午?	agreed
三明一楼房倒塌现场辗压死了好几个人	啤酒这么洗头，白发不管多严重，8分钟漆黑像丝绸，一生不烫染发	unrelated
日常生活中食物相克	警惕！日常饮食中必须引起注意的10种「相克食物」搭配	agreed
宝宝出生时越重越聪明？不！这体重才最好！	宝宝智商竟与出生体重有关？这个体重的宝宝最聪明	agreed
不敢相信潘长江之女去世，知道真相的网友眼泪掉下来！	泪目！女儿潘阳被传去世，潘长江情绪失控，道出真相让人寒心	unrelated
宝贝喜欢向左侧身睡，会不会压迫心脏？	睡觉朝哪边睡更好？左侧睡会压迫心脏吗？	agreed
睡前“一穴一汤”，让你3分钟进入深度睡眠，一觉到天亮	睡前吃10颗它，帮你摆脱失眠困扰，一觉睡到天亮！	unrelated
99%娱乐圈明星都极度害怕向华强，成龙曾被逼着向梅艳芳下跪！	向华强干出这事，逼成龙下跪，暴打大佬曾志伟，见到这二人秒怂	unrelated
自从用了这个小妙招，啤酒都敢放开喝，不怕出现啤酒肚	农村危房补贴又添120亿，明年全部发放完毕，你可以领多少？	unrelated
范冰冰终于捅破了和成龙的这种关系，难怪李晨迟迟不愿娶她	成龙范冰冰的忘年交 绝对不是纯友谊只因看完这张图片	unrelated
夏天蚊子最怕这种植物！家里摆两盆，蚊子不敢进屋，给你舒适环境	夏天蚊子最怕这种植物！家里摆两盆，蚊子不敢进屋，还清新空气	agreed
沙湾有人吃羊肉得了SK6病毒？切！我还SK2呢！	“SK5病毒”又来了？贵阳网警辟谣：勿信！	unrelated
橘子也分公母，学会这两招，让你挑的橘子又甜又可口，超实用	霍金预言：2032年小行星撞地球，人类这次逃不掉了！4	unrelated
彭于晏被投资人睡了	大蒜泡它，老汉变青年 7天白发全部变黑发，这辈子都不用在染发	unrelated
健十教你如何预防和改善高血压问题	高血压冬季更易发病，如何保健预防血压升高丨健康	agreed
宋小宝自曝暂退娱乐圈原因，赵本山不知情却也选择支持徒弟	宋小宝得了这个病，不得不暂退娱乐圈，有钱没健康一切都白忙！	unrelated
手机拨号键输入这段代码，让你的手机号码变成空号，赶快试试	手机来电不想接，挂断又尴尬？教你这样设置，对方听到手机是空号	agreed
开始不认识这些摄像头 三个驾驶证的分都不够扣!	交警提醒广大车主:不认识这5种摄像头,给你100分也不够扣!	agreed
大咖头条 出轨大戏再次上演！杨幂婚姻遇危机 刘恺威出轨	谣言粉碎机丨喷射彩条有危险？	unrelated
景甜带张继科见父母，30岁的她这是要打算结婚了吗？	张继科景甜已登记结婚？景甜方辟谣：假消息！	disagreed
大家天天吃的玉米会致癌，快别再吃了	街上这些闻着超香的玉米真的别吃了，易致癌！	agreed
1962年中印边界自卫反击战爆发，印度连女人孩子都被拉上战场	对印自卫的反击战，中国军队打的印度军队节节败退！	unrelated
18888888888手机号拍出1.2亿	凤姐辟谣：公众号文章并非自己所写 凤凰前主编策划	unrelated
无耻的商家，这是紫菜吗？不要脸的商家，是塑料袋做的吧！！	紫菜竟然用塑料袋做的！！！	agreed
事业单位改革新条例：有些人再涨薪资，有些人却将没有工资！	事业单位涨工资？	unrelated
普洱茶致癌到底是怎么回事？看看微头条上的权威人士怎么说	星巴克咖啡致癌？这则谣言，并不值得中国茶欢呼！	unrelated
净网2018「揭西警讯」揭西公安机关依法处置一宗谣言案	无人机将参与白城交通执法系谣言！	unrelated
产后女人这样做，彻底告别“黄脸婆”，皮肤红润有光泽！	年纪轻轻脸色就发黄？教你几招让你肌肤红润有光泽，不做黄脸婆	agreed
2017年元旦起,驾驶证年龄标准实行新规，不看后悔！切记！	2017年驾驶证年龄新规定算算你还能开几年车	agreed
中国公开全力支持朝鲜，美国政府顿时惊慌失措	辟谣｜萨德安装发生爆炸？韩国领导下跪道歉？麻烦理性爱国！	unrelated
教你光绪元宝 大清铜币快速知锈，一眼识别伪币	谣言：很多人觉得罐头食品一年半载不变质，	unrelated
公公强吻儿媳后两家人现场斗殴？现场视频系张冠李戴	网警辟谣“学生跳楼”对公众号经营者批评教育	unrelated
主持人问于文华跟尹相杰为啥没成，台下朱之文在傻笑	“麦克阿瑟问日本天皇：你为啥不剖腹？”是谣言，真实对话如下	unrelated
“洛阳纸贵”，4天32家纸厂涨价！然而比造纸还赚的是这些股票	海关总署辟谣“海淘奶粉涨价”：未出台新政 勿过度解读	unrelated
传闻中迪丽热巴的豪宅，奢华程度不输杨幂！	还说刘恺威不爱杨幂，买3000万豪宅坚持写杨幂的名字	unrelated
怀孕看性别，B超单有这四个字，男孩的几率很大，你知道吗？	留意B超单上的这四个字，可以知晓胎儿性别！	agreed
12306数据泄漏	铁路12306 辟谣，称网站未发生用户信息泄漏！	disagreed
一滴血就能测天赋、测性格、测姻缘	一滴血测天赋测性格姻缘 靠谱吗？	agreed
大暴雨下的深圳地铁被水淹 这画面曝光有点惨不忍睹	辟谣：“汶川都被淹完了”假的！只有一个片区出现进水	unrelated
美味也危险？“蕨菜致癌”尚未定论	蕨菜也能致癌？	unrelated
手机微信删除的聊天记录如何恢复：菜鸟必读教程	一招教你快速查找微信聊天记录的方法！	agreed
粉丝塑料做？虾有寄生虫？吃发物癌复发？别逗了	10大健康类谣言出炉：癌症因为运气差？可惜真相没几个人知道	unrelated
喜报：农村这些违章建筑现在合法了，不仅免税，还能享受补贴！	农村这些违规建筑，终于合法了，不仅可以免税，还可以优质补贴	agreed
范冰冰李晨已领证？小两口好事将近为婚礼作准备！	范冰冰疑似不雅照男主现身辟谣，黄毅清“猛料”遭打脸！	unrelated
山西省吕梁市临县，小食品吃死兄弟两，各13岁-11岁，编的民	著名二人转演员在昨日因病抢救无效死亡，此歌一响，赵本山痛哭	unrelated
奥巴梅扬要来中超了！目的地是恒大，不是国安也不是权健！	更衣室内讧谣言令权健大将怒火中烧 俱乐部速发声明予以回应	unrelated
某董事爆李小璐贾乃亮已离婚！甜馨归女方，李小璐发博讽刺贾乃亮	贾乃亮工作室辟谣：提问甜馨“妈妈给谁带绿帽子”的视频	unrelated
